*********** # 1 **************
PokerStars Hand #149652067173: Tournament #1495192630, $0.91+$0.09 USD Hold'em No Limit - Level XI (400/800) - 2016/03/01 1:34:24 ET
Table '1495192630 3' 9-max Seat #4 is the button
Seat 3: Irisha2 (24264 in chips)
Seat 4: DmelloH (26893 in chips)
Seat 9: held (16343 in chips)
Irisha2: posts the ante 50
DmelloH: posts the ante 50
held: posts the ante 50
held: posts small blind 400
Irisha2: posts big blind 800
*** HOLE CARDS ***
Dealt to held [Kd Jh]
DmelloH: folds
held: raises 977 to 1777
Irisha2: calls 977
*** FLOP *** [7h Th Js]
held: checks
Irisha2: bets 3200
held: raises 3466 to 6666
Irisha2: raises 15771 to 22437 and is all-in
held: calls 7850 and is all-in
Uncalled bet (7921) returned to Irisha2
*** TURN *** [7h Th Js] [6d]
*** RIVER *** [7h Th Js 6d] [9c]
*** SHOW DOWN ***
held: shows [Kd Jh] (a pair of Jacks)
Irisha2: shows [8s 9s] (a straight, Seven to Jack)
Irisha2 collected 32736 from pot
held finished the tournament in 3rd place and received $6.75.
*** SUMMARY ***
Total pot 32736 | Rake 0
Board [7h Th Js 6d 9c]
Seat 3: Irisha2 (big blind) showed [8s 9s] and won (32736) with a straight, Seven to Jack
Seat 4: DmelloH (button) folded before Flop (didn't bet)
Seat 9: held (small blind) showed [Kd Jh] and lost with a pair of Jacks


*********** # 2 **************
PokerStars Hand #149652059422: Tournament #1495192630, $0.91+$0.09 USD Hold'em No Limit - Level XI (400/800) - 2016/03/01 1:33:54 ET
Table '1495192630 3' 9-max Seat #3 is the button
Seat 1: Fischersito (3475 in chips)
Seat 3: Irisha2 (24314 in chips)
Seat 4: DmelloH (33302 in chips)
Seat 9: held (6409 in chips)
Fischersito: posts the ante 50
Irisha2: posts the ante 50
DmelloH: posts the ante 50
held: posts the ante 50
DmelloH: posts small blind 400
held: posts big blind 800
*** HOLE CARDS ***
Dealt to held [Qd Qs]
Fischersito: raises 2625 to 3425 and is all-in
Irisha2: folds
DmelloH: calls 3025
held: raises 2934 to 6359 and is all-in
DmelloH: calls 2934
*** FLOP *** [8h Kd 2s]
*** TURN *** [8h Kd 2s] [6s]
*** RIVER *** [8h Kd 2s 6s] [4s]
*** SHOW DOWN ***
DmelloH: shows [7h 7d] (a pair of Sevens)
held: shows [Qd Qs] (a pair of Queens)
held collected 5868 from side pot
Fischersito: shows [2c Ad] (a pair of Deuces)
held collected 10475 from main pot
Fischersito finished the tournament in 4th place and received $5.11.
*** SUMMARY ***
Total pot 16343 Main pot 10475. Side pot 5868. | Rake 0
Board [8h Kd 2s 6s 4s]
Seat 1: Fischersito showed [2c Ad] and lost with a pair of Deuces
Seat 3: Irisha2 (button) folded before Flop (didn't bet)
Seat 4: DmelloH (small blind) showed [7h 7d] and lost with a pair of Sevens
Seat 9: held (big blind) showed [Qd Qs] and won (16343) with a pair of Queens


*********** # 3 **************
PokerStars Hand #149652054275: Tournament #1495192630, $0.91+$0.09 USD Hold'em No Limit - Level XI (400/800) - 2016/03/01 1:33:35 ET
Table '1495192630 3' 9-max Seat #1 is the button
Seat 1: Fischersito (3525 in chips)
Seat 3: Irisha2 (24764 in chips)
Seat 4: DmelloH (34152 in chips)
Seat 9: held (5059 in chips)
Fischersito: posts the ante 50
Irisha2: posts the ante 50
DmelloH: posts the ante 50
held: posts the ante 50
Irisha2: posts small blind 400
DmelloH: posts big blind 800
*** HOLE CARDS ***
Dealt to held [Ad 9s]
held: raises 2533 to 3333
Fischersito: folds
Irisha2: folds
DmelloH: folds
Uncalled bet (2533) returned to held
held collected 2200 from pot
held: doesn't show hand
*** SUMMARY ***
Total pot 2200 | Rake 0
Seat 1: Fischersito (button) folded before Flop (didn't bet)
Seat 3: Irisha2 (small blind) folded before Flop
Seat 4: DmelloH (big blind) folded before Flop
Seat 9: held collected (2200)


*********** # 4 **************
PokerStars Hand #149652051096: Tournament #1495192630, $0.91+$0.09 USD Hold'em No Limit - Level XI (400/800) - 2016/03/01 1:33:23 ET
Table '1495192630 3' 9-max Seat #9 is the button
Seat 1: Fischersito (3975 in chips)
Seat 3: Irisha2 (24214 in chips)
Seat 4: DmelloH (34202 in chips)
Seat 9: held (5109 in chips)
Fischersito: posts the ante 50
Irisha2: posts the ante 50
DmelloH: posts the ante 50
held: posts the ante 50
Fischersito: posts small blind 400
Irisha2: posts big blind 800
*** HOLE CARDS ***
Dealt to held [8h 2h]
DmelloH: folds
held: folds
Fischersito: folds
Uncalled bet (400) returned to Irisha2
Irisha2 collected 1000 from pot
Irisha2: doesn't show hand
*** SUMMARY ***
Total pot 1000 | Rake 0
Seat 1: Fischersito (small blind) folded before Flop
Seat 3: Irisha2 (big blind) collected (1000)
Seat 4: DmelloH folded before Flop (didn't bet)
Seat 9: held (button) folded before Flop (didn't bet)


*********** # 5 **************
PokerStars Hand #149652043462: Tournament #1495192630, $0.91+$0.09 USD Hold'em No Limit - Level XI (400/800) - 2016/03/01 1:32:54 ET
Table '1495192630 3' 9-max Seat #4 is the button
Seat 1: Fischersito (4825 in chips)
Seat 3: Irisha2 (24264 in chips)
Seat 4: DmelloH (34252 in chips)
Seat 9: held (4159 in chips)
Fischersito: posts the ante 50
Irisha2: posts the ante 50
DmelloH: posts the ante 50
held: posts the ante 50
held: posts small blind 400
Fischersito: posts big blind 800
*** HOLE CARDS ***
Dealt to held [9c 8s]
Irisha2: folds
DmelloH: folds
held: raises 3309 to 4109 and is all-in
Fischersito: folds
Uncalled bet (3309) returned to held
held collected 1800 from pot
held: doesn't show hand
*** SUMMARY ***
Total pot 1800 | Rake 0
Seat 1: Fischersito (big blind) folded before Flop
Seat 3: Irisha2 folded before Flop (didn't bet)
Seat 4: DmelloH (button) folded before Flop (didn't bet)
Seat 9: held (small blind) collected (1800)


*********** # 6 **************
PokerStars Hand #149652035440: Tournament #1495192630, $0.91+$0.09 USD Hold'em No Limit - Level XI (400/800) - 2016/03/01 1:32:23 ET
Table '1495192630 3' 9-max Seat #3 is the button
Seat 1: Fischersito (4875 in chips)
Seat 3: Irisha2 (24314 in chips)
Seat 4: DmelloH (34702 in chips)
Seat 9: held (3609 in chips)
Fischersito: posts the ante 50
Irisha2: posts the ante 50
DmelloH: posts the ante 50
held: posts the ante 50
DmelloH: posts small blind 400
held: posts big blind 800
*** HOLE CARDS ***
Dealt to held [Kh 4c]
Fischersito: folds
Irisha2: folds
DmelloH: folds
Uncalled bet (400) returned to held
held collected 1000 from pot
held: doesn't show hand
*** SUMMARY ***
Total pot 1000 | Rake 0
Seat 1: Fischersito folded before Flop (didn't bet)
Seat 3: Irisha2 (button) folded before Flop (didn't bet)
Seat 4: DmelloH (small blind) folded before Flop
Seat 9: held (big blind) collected (1000)


*********** # 7 **************
PokerStars Hand #149652017195: Tournament #1495192630, $0.91+$0.09 USD Hold'em No Limit - Level XI (400/800) - 2016/03/01 1:31:14 ET
Table '1495192630 3' 9-max Seat #1 is the button
Seat 1: Fischersito (4925 in chips)
Seat 3: Irisha2 (24764 in chips)
Seat 4: DmelloH (17101 in chips)
Seat 9: held (20710 in chips)
Fischersito: posts the ante 50
Irisha2: posts the ante 50
DmelloH: posts the ante 50
held: posts the ante 50
Irisha2: posts small blind 400
DmelloH: posts big blind 800
*** HOLE CARDS ***
Dealt to held [Ad Td]
held: raises 1199 to 1999
Fischersito: folds
Irisha2: folds
DmelloH: calls 1199
*** FLOP *** [Ks 8h 9c]
DmelloH: bets 4598
held: raises 14063 to 18661 and is all-in
DmelloH: calls 10454 and is all-in
Uncalled bet (3609) returned to held
*** TURN *** [Ks 8h 9c] [Jc]
*** RIVER *** [Ks 8h 9c Jc] [6c]
*** SHOW DOWN ***
DmelloH: shows [Qd Kh] (a pair of Kings)
held: shows [Ad Td] (high card Ace)
DmelloH collected 34702 from pot
*** SUMMARY ***
Total pot 34702 | Rake 0
Board [Ks 8h 9c Jc 6c]
Seat 1: Fischersito (button) folded before Flop (didn't bet)
Seat 3: Irisha2 (small blind) folded before Flop
Seat 4: DmelloH (big blind) showed [Qd Kh] and won (34702) with a pair of Kings
Seat 9: held showed [Ad Td] and lost with high card Ace


*********** # 8 **************
PokerStars Hand #149652008315: Tournament #1495192630, $0.91+$0.09 USD Hold'em No Limit - Level XI (400/800) - 2016/03/01 1:30:41 ET
Table '1495192630 3' 9-max Seat #9 is the button
Seat 1: Fischersito (5375 in chips)
Seat 3: Irisha2 (26414 in chips)
Seat 4: DmelloH (14951 in chips)
Seat 9: held (20760 in chips)
Fischersito: posts the ante 50
Irisha2: posts the ante 50
DmelloH: posts the ante 50
held: posts the ante 50
Fischersito: posts small blind 400
Irisha2: posts big blind 800
*** HOLE CARDS ***
Dealt to held [Kd 4d]
DmelloH: raises 800 to 1600
held: folds
Fischersito: folds
Irisha2: calls 800
*** FLOP *** [Jd 2c Ac]
Irisha2: checks
DmelloH: bets 1900
Irisha2: folds
Uncalled bet (1900) returned to DmelloH
DmelloH collected 3800 from pot
DmelloH: doesn't show hand
*** SUMMARY ***
Total pot 3800 | Rake 0
Board [Jd 2c Ac]
Seat 1: Fischersito (small blind) folded before Flop
Seat 3: Irisha2 (big blind) folded on the Flop
Seat 4: DmelloH collected (3800)
Seat 9: held (button) folded before Flop (didn't bet)


*********** # 9 **************
PokerStars Hand #149652003458: Tournament #1495192630, $0.91+$0.09 USD Hold'em No Limit - Level XI (400/800) - 2016/03/01 1:30:22 ET
Table '1495192630 3' 9-max Seat #4 is the button
Seat 1: Fischersito (7025 in chips)
Seat 3: Irisha2 (24264 in chips)
Seat 4: DmelloH (15001 in chips)
Seat 9: held (21210 in chips)
Fischersito: posts the ante 50
Irisha2: posts the ante 50
DmelloH: posts the ante 50
held: posts the ante 50
held: posts small blind 400
Fischersito: posts big blind 800
*** HOLE CARDS ***
Dealt to held [Ts 3s]
Irisha2: raises 800 to 1600
DmelloH: folds
held: folds
Fischersito: calls 800
*** FLOP *** [3d Kc Kh]
Fischersito: checks
Irisha2: bets 800
Fischersito: folds
Uncalled bet (800) returned to Irisha2
Irisha2 collected 3800 from pot
Irisha2: doesn't show hand
*** SUMMARY ***
Total pot 3800 | Rake 0
Board [3d Kc Kh]
Seat 1: Fischersito (big blind) folded on the Flop
Seat 3: Irisha2 collected (3800)
Seat 4: DmelloH (button) folded before Flop (didn't bet)
Seat 9: held (small blind) folded before Flop


*********** # 10 **************
PokerStars Hand #149651992548: Tournament #1495192630, $0.91+$0.09 USD Hold'em No Limit - Level XI (400/800) - 2016/03/01 1:29:41 ET
Table '1495192630 3' 9-max Seat #3 is the button
Seat 1: Fischersito (15875 in chips)
Seat 3: Irisha2 (14114 in chips)
Seat 4: DmelloH (15451 in chips)
Seat 9: held (22060 in chips)
Fischersito: posts the ante 50
Irisha2: posts the ante 50
DmelloH: posts the ante 50
held: posts the ante 50
DmelloH: posts small blind 400
held: posts big blind 800
*** HOLE CARDS ***
Dealt to held [4c 2d]
Fischersito: raises 800 to 1600
Irisha2: calls 1600
DmelloH: folds
held: folds
*** FLOP *** [3c Jc 3h]
Fischersito: bets 2400
Irisha2: calls 2400
*** TURN *** [3c Jc 3h] [6h]
Fischersito: checks
Irisha2: bets 1600
Fischersito: calls 1600
*** RIVER *** [3c Jc 3h 6h] [3d]
Fischersito: checks
Irisha2: bets 3200
Fischersito: calls 3200
*** SHOW DOWN ***
Irisha2: shows [Jh Qs] (a full house, Threes full of Jacks)
Fischersito: mucks hand
Irisha2 collected 19000 from pot
*** SUMMARY ***
Total pot 19000 | Rake 0
Board [3c Jc 3h 6h 3d]
Seat 1: Fischersito mucked [Td Tc]
Seat 3: Irisha2 (button) showed [Jh Qs] and won (19000) with a full house, Threes full of Jacks
Seat 4: DmelloH (small blind) folded before Flop
Seat 9: held (big blind) folded before Flop


*********** # 11 **************
PokerStars Hand #149651986994: Tournament #1495192630, $0.91+$0.09 USD Hold'em No Limit - Level XI (400/800) - 2016/03/01 1:29:20 ET
Table '1495192630 3' 9-max Seat #1 is the button
Seat 1: Fischersito (14525 in chips)
Seat 3: Irisha2 (14564 in chips)
Seat 4: DmelloH (16301 in chips)
Seat 9: held (22110 in chips)
Fischersito: posts the ante 50
Irisha2: posts the ante 50
DmelloH: posts the ante 50
held: posts the ante 50
Irisha2: posts small blind 400
DmelloH: posts big blind 800
*** HOLE CARDS ***
Dealt to held [Ah 2c]
held: folds
Fischersito: raises 800 to 1600
Irisha2: folds
DmelloH: folds
Uncalled bet (800) returned to Fischersito
Fischersito collected 2200 from pot
Fischersito: doesn't show hand
*** SUMMARY ***
Total pot 2200 | Rake 0
Seat 1: Fischersito (button) collected (2200)
Seat 3: Irisha2 (small blind) folded before Flop
Seat 4: DmelloH (big blind) folded before Flop
Seat 9: held folded before Flop (didn't bet)


*********** # 12 **************
PokerStars Hand #149651982765: Tournament #1495192630, $0.91+$0.09 USD Hold'em No Limit - Level XI (400/800) - 2016/03/01 1:29:05 ET
Table '1495192630 3' 9-max Seat #9 is the button
Seat 1: Fischersito (14975 in chips)
Seat 3: Irisha2 (15414 in chips)
Seat 4: DmelloH (16351 in chips)
Seat 9: held (20760 in chips)
Fischersito: posts the ante 50
Irisha2: posts the ante 50
DmelloH: posts the ante 50
held: posts the ante 50
Fischersito: posts small blind 400
Irisha2: posts big blind 800
*** HOLE CARDS ***
Dealt to held [Jh Ts]
DmelloH: folds
held: raises 1088 to 1888
Fischersito: folds
Irisha2: folds
Uncalled bet (1088) returned to held
held collected 2200 from pot
held: doesn't show hand
*** SUMMARY ***
Total pot 2200 | Rake 0
Seat 1: Fischersito (small blind) folded before Flop
Seat 3: Irisha2 (big blind) folded before Flop
Seat 4: DmelloH folded before Flop (didn't bet)
Seat 9: held (button) collected (2200)


*********** # 13 **************
PokerStars Hand #149651974379: Tournament #1495192630, $0.91+$0.09 USD Hold'em No Limit - Level XI (400/800) - 2016/03/01 1:28:33 ET
Table '1495192630 3' 9-max Seat #4 is the button
Seat 1: Fischersito (15825 in chips)
Seat 3: Irisha2 (15464 in chips)
Seat 4: DmelloH (16401 in chips)
Seat 9: held (19810 in chips)
Fischersito: posts the ante 50
Irisha2: posts the ante 50
DmelloH: posts the ante 50
held: posts the ante 50
held: posts small blind 400
Fischersito: posts big blind 800
*** HOLE CARDS ***
Dealt to held [6c 3c]
Irisha2: folds
DmelloH: folds
held: calls 400
Fischersito: checks
*** FLOP *** [2c 7h 6d]
held: bets 999
Fischersito: folds
Uncalled bet (999) returned to held
held collected 1800 from pot
held: doesn't show hand
*** SUMMARY ***
Total pot 1800 | Rake 0
Board [2c 7h 6d]
Seat 1: Fischersito (big blind) folded on the Flop
Seat 3: Irisha2 folded before Flop (didn't bet)
Seat 4: DmelloH (button) folded before Flop (didn't bet)
Seat 9: held (small blind) collected (1800)


*********** # 14 **************
PokerStars Hand #149651956955: Tournament #1495192630, $0.91+$0.09 USD Hold'em No Limit - Level XI (400/800) - 2016/03/01 1:27:28 ET
Table '1495192630 3' 9-max Seat #3 is the button
Seat 1: Fischersito (15875 in chips)
Seat 3: Irisha2 (11092 in chips)
Seat 4: DmelloH (16851 in chips)
Seat 9: held (23682 in chips)
Fischersito: posts the ante 50
Irisha2: posts the ante 50
DmelloH: posts the ante 50
held: posts the ante 50
DmelloH: posts small blind 400
held: posts big blind 800
*** HOLE CARDS ***
Dealt to held [Ks 5d]
Fischersito: folds
Irisha2: raises 800 to 1600
DmelloH: folds
held: calls 800
*** FLOP *** [Ac 4s 2c]
held: checks
Irisha2: checks
*** TURN *** [Ac 4s 2c] [3h]
held: bets 2222
Irisha2: raises 2578 to 4800
held: folds
Uncalled bet (2578) returned to Irisha2
Irisha2 collected 8244 from pot
Irisha2: doesn't show hand
*** SUMMARY ***
Total pot 8244 | Rake 0
Board [Ac 4s 2c 3h]
Seat 1: Fischersito folded before Flop (didn't bet)
Seat 3: Irisha2 (button) collected (8244)
Seat 4: DmelloH (small blind) folded before Flop
Seat 9: held (big blind) folded on the Turn


*********** # 15 **************
PokerStars Hand #149651945936: Tournament #1495192630, $0.91+$0.09 USD Hold'em No Limit - Level XI (400/800) - 2016/03/01 1:26:46 ET
Table '1495192630 3' 9-max Seat #1 is the button
Seat 1: Fischersito (13725 in chips)
Seat 3: Irisha2 (11542 in chips)
Seat 4: DmelloH (18501 in chips)
Seat 9: held (23732 in chips)
Fischersito: posts the ante 50
Irisha2: posts the ante 50
DmelloH: posts the ante 50
held: posts the ante 50
Irisha2: posts small blind 400
DmelloH: posts big blind 800
*** HOLE CARDS ***
Dealt to held [2c Jc]
held: folds
Fischersito: raises 800 to 1600
Irisha2: folds
DmelloH: calls 800
*** FLOP *** [8s 7d 4c]
DmelloH: checks
Fischersito: bets 1600
DmelloH: folds
Uncalled bet (1600) returned to Fischersito
Fischersito collected 3800 from pot
Fischersito: doesn't show hand
*** SUMMARY ***
Total pot 3800 | Rake 0
Board [8s 7d 4c]
Seat 1: Fischersito (button) collected (3800)
Seat 3: Irisha2 (small blind) folded before Flop
Seat 4: DmelloH (big blind) folded on the Flop
Seat 9: held folded before Flop (didn't bet)


*********** # 16 **************
PokerStars Hand #149651931213: Tournament #1495192630, $0.91+$0.09 USD Hold'em No Limit - Level XI (400/800) - 2016/03/01 1:25:51 ET
Table '1495192630 3' 9-max Seat #9 is the button
Seat 1: Fischersito (14175 in chips)
Seat 3: Irisha2 (15880 in chips)
Seat 4: DmelloH (18551 in chips)
Seat 9: held (18894 in chips)
Fischersito: posts the ante 50
Irisha2: posts the ante 50
DmelloH: posts the ante 50
held: posts the ante 50
Fischersito: posts small blind 400
Irisha2: posts big blind 800
*** HOLE CARDS ***
Dealt to held [Ts Ad]
DmelloH: folds
held: raises 1088 to 1888
Fischersito: folds
Irisha2: calls 1088
*** FLOP *** [9s 3h 2h]
Irisha2: checks
held: checks
*** TURN *** [9s 3h 2h] [8s]
Irisha2: bets 1600
held: calls 1600
*** RIVER *** [9s 3h 2h 8s] [Kc]
Irisha2: bets 800
held: raises 3644 to 4444
Irisha2: folds
Uncalled bet (3644) returned to held
held collected 9176 from pot
held: doesn't show hand
*** SUMMARY ***
Total pot 9176 | Rake 0
Board [9s 3h 2h 8s Kc]
Seat 1: Fischersito (small blind) folded before Flop
Seat 3: Irisha2 (big blind) folded on the River
Seat 4: DmelloH folded before Flop (didn't bet)
Seat 9: held (button) collected (9176)


*********** # 17 **************
PokerStars Hand #149651928183: Tournament #1495192630, $0.91+$0.09 USD Hold'em No Limit - Level XI (400/800) - 2016/03/01 1:25:39 ET
Table '1495192630 3' 9-max Seat #4 is the button
Seat 1: Fischersito (13625 in chips)
Seat 3: Irisha2 (15930 in chips)
Seat 4: DmelloH (18601 in chips)
Seat 9: held (19344 in chips)
Fischersito: posts the ante 50
Irisha2: posts the ante 50
DmelloH: posts the ante 50
held: posts the ante 50
held: posts small blind 400
Fischersito: posts big blind 800
*** HOLE CARDS ***
Dealt to held [5d 7s]
Irisha2: folds
DmelloH: folds
held: folds
Uncalled bet (400) returned to Fischersito
Fischersito collected 1000 from pot
Fischersito: doesn't show hand
*** SUMMARY ***
Total pot 1000 | Rake 0
Seat 1: Fischersito (big blind) collected (1000)
Seat 3: Irisha2 folded before Flop (didn't bet)
Seat 4: DmelloH (button) folded before Flop (didn't bet)
Seat 9: held (small blind) folded before Flop


*********** # 18 **************
PokerStars Hand #149651921849: Tournament #1495192630, $0.91+$0.09 USD Hold'em No Limit - Level X (300/600) - 2016/03/01 1:25:15 ET
Table '1495192630 3' 9-max Seat #3 is the button
Seat 1: Fischersito (13675 in chips)
Seat 3: Irisha2 (15980 in chips)
Seat 4: DmelloH (18951 in chips)
Seat 9: held (18894 in chips)
Fischersito: posts the ante 50
Irisha2: posts the ante 50
DmelloH: posts the ante 50
held: posts the ante 50
DmelloH: posts small blind 300
held: posts big blind 600
*** HOLE CARDS ***
Dealt to held [Ts Jh]
Fischersito: folds
Irisha2: folds
DmelloH: folds
Uncalled bet (300) returned to held
held collected 800 from pot
held: doesn't show hand
*** SUMMARY ***
Total pot 800 | Rake 0
Seat 1: Fischersito folded before Flop (didn't bet)
Seat 3: Irisha2 (button) folded before Flop (didn't bet)
Seat 4: DmelloH (small blind) folded before Flop
Seat 9: held (big blind) collected (800)


*********** # 19 **************
PokerStars Hand #149651916252: Tournament #1495192630, $0.91+$0.09 USD Hold'em No Limit - Level X (300/600) - 2016/03/01 1:24:54 ET
Table '1495192630 3' 9-max Seat #2 is the button
Seat 1: Fischersito (13725 in chips)
Seat 2: Thore H (6202 in chips)
Seat 3: Irisha2 (16330 in chips)
Seat 4: DmelloH (12299 in chips)
Seat 9: held (18944 in chips)
Fischersito: posts the ante 50
Thore H: posts the ante 50
Irisha2: posts the ante 50
DmelloH: posts the ante 50
held: posts the ante 50
Irisha2: posts small blind 300
DmelloH: posts big blind 600
*** HOLE CARDS ***
Dealt to held [Js 8c]
held: folds
Fischersito: folds
Thore H: raises 5552 to 6152 and is all-in
Irisha2: folds
DmelloH: calls 5552
*** FLOP *** [3c Kc 6s]
*** TURN *** [3c Kc 6s] [Ac]
*** RIVER *** [3c Kc 6s Ac] [Kd]
*** SHOW DOWN ***
DmelloH: shows [Jh Ah] (two pair, Aces and Kings)
Thore H: shows [Qh 6d] (two pair, Kings and Sixes)
DmelloH collected 12854 from pot
Thore H finished the tournament in 5th place and received $3.68.
*** SUMMARY ***
Total pot 12854 | Rake 0
Board [3c Kc 6s Ac Kd]
Seat 1: Fischersito folded before Flop (didn't bet)
Seat 2: Thore H (button) showed [Qh 6d] and lost with two pair, Kings and Sixes
Seat 3: Irisha2 (small blind) folded before Flop
Seat 4: DmelloH (big blind) showed [Jh Ah] and won (12854) with two pair, Aces and Kings
Seat 9: held folded before Flop (didn't bet)


*********** # 20 **************
PokerStars Hand #149651909231: Tournament #1495192630, $0.91+$0.09 USD Hold'em No Limit - Level X (300/600) - 2016/03/01 1:24:27 ET
Table '1495192630 3' 9-max Seat #1 is the button
Seat 1: Fischersito (13775 in chips)
Seat 2: Thore H (6552 in chips)
Seat 3: Irisha2 (16980 in chips)
Seat 4: DmelloH (12949 in chips)
Seat 9: held (17244 in chips)
Fischersito: posts the ante 50
Thore H: posts the ante 50
Irisha2: posts the ante 50
DmelloH: posts the ante 50
held: posts the ante 50
Thore H: posts small blind 300
Irisha2: posts big blind 600
*** HOLE CARDS ***
Dealt to held [As 8d]
DmelloH: calls 600
held: raises 1622 to 2222
Fischersito: folds
Thore H: folds
Irisha2: folds
DmelloH: folds
Uncalled bet (1622) returned to held
held collected 2350 from pot
held: doesn't show hand
*** SUMMARY ***
Total pot 2350 | Rake 0
Seat 1: Fischersito (button) folded before Flop (didn't bet)
Seat 2: Thore H (small blind) folded before Flop
Seat 3: Irisha2 (big blind) folded before Flop
Seat 4: DmelloH folded before Flop
Seat 9: held collected (2350)


*********** # 21 **************
PokerStars Hand #149651893755: Tournament #1495192630, $0.91+$0.09 USD Hold'em No Limit - Level X (300/600) - 2016/03/01 1:23:29 ET
Table '1495192630 3' 9-max Seat #9 is the button
Seat 1: Fischersito (10575 in chips)
Seat 2: Thore H (7202 in chips)
Seat 3: Irisha2 (18830 in chips)
Seat 4: DmelloH (12999 in chips)
Seat 9: held (17894 in chips)
Fischersito: posts the ante 50
Thore H: posts the ante 50
Irisha2: posts the ante 50
DmelloH: posts the ante 50
held: posts the ante 50
Fischersito: posts small blind 300
Thore H: posts big blind 600
*** HOLE CARDS ***
Dealt to held [Ks 9s]
Irisha2: calls 600
DmelloH: folds
held: calls 600
Fischersito: calls 300
Thore H: checks
*** FLOP *** [3d 6c Ts]
Fischersito: checks
Thore H: checks
Irisha2: checks
held: checks
*** TURN *** [3d 6c Ts] [Jh]
Fischersito: bets 1200
Thore H: folds
Irisha2: calls 1200
held: folds
*** RIVER *** [3d 6c Ts Jh] [Th]
Fischersito: bets 2400
Irisha2: folds
Uncalled bet (2400) returned to Fischersito
Fischersito collected 5050 from pot
Fischersito: doesn't show hand
*** SUMMARY ***
Total pot 5050 | Rake 0
Board [3d 6c Ts Jh Th]
Seat 1: Fischersito (small blind) collected (5050)
Seat 2: Thore H (big blind) folded on the Turn
Seat 3: Irisha2 folded on the River
Seat 4: DmelloH folded before Flop (didn't bet)
Seat 9: held (button) folded on the Turn


*********** # 22 **************
PokerStars Hand #149651886903: Tournament #1495192630, $0.91+$0.09 USD Hold'em No Limit - Level X (300/600) - 2016/03/01 1:23:03 ET
Table '1495192630 3' 9-max Seat #4 is the button
Seat 1: Fischersito (11225 in chips)
Seat 2: Thore H (7252 in chips)
Seat 3: Irisha2 (18880 in chips)
Seat 4: DmelloH (13049 in chips)
Seat 9: held (17094 in chips)
Fischersito: posts the ante 50
Thore H: posts the ante 50
Irisha2: posts the ante 50
DmelloH: posts the ante 50
held: posts the ante 50
held: posts small blind 300
Fischersito: posts big blind 600
*** HOLE CARDS ***
Dealt to held [8s Kd]
Thore H: folds
Irisha2: folds
DmelloH: folds
held: raises 955 to 1555
Fischersito: folds
Uncalled bet (955) returned to held
held collected 1450 from pot
held: doesn't show hand
*** SUMMARY ***
Total pot 1450 | Rake 0
Seat 1: Fischersito (big blind) folded before Flop
Seat 2: Thore H folded before Flop (didn't bet)
Seat 3: Irisha2 folded before Flop (didn't bet)
Seat 4: DmelloH (button) folded before Flop (didn't bet)
Seat 9: held (small blind) collected (1450)


*********** # 23 **************
PokerStars Hand #149651882646: Tournament #1495192630, $0.91+$0.09 USD Hold'em No Limit - Level X (300/600) - 2016/03/01 1:22:47 ET
Table '1495192630 3' 9-max Seat #3 is the button
Seat 1: Fischersito (11275 in chips)
Seat 2: Thore H (6152 in chips)
Seat 3: Irisha2 (18930 in chips)
Seat 4: DmelloH (13399 in chips)
Seat 9: held (17744 in chips)
Fischersito: posts the ante 50
Thore H: posts the ante 50
Irisha2: posts the ante 50
DmelloH: posts the ante 50
held: posts the ante 50
DmelloH: posts small blind 300
held: posts big blind 600
*** HOLE CARDS ***
Dealt to held [Ks 9c]
Fischersito: folds
Thore H: raises 5502 to 6102 and is all-in
Irisha2: folds
DmelloH: folds
held: folds
Uncalled bet (5502) returned to Thore H
Thore H collected 1750 from pot
*** SUMMARY ***
Total pot 1750 | Rake 0
Seat 1: Fischersito folded before Flop (didn't bet)
Seat 2: Thore H collected (1750)
Seat 3: Irisha2 (button) folded before Flop (didn't bet)
Seat 4: DmelloH (small blind) folded before Flop
Seat 9: held (big blind) folded before Flop


*********** # 24 **************
PokerStars Hand #149651877870: Tournament #1495192630, $0.91+$0.09 USD Hold'em No Limit - Level X (300/600) - 2016/03/01 1:22:29 ET
Table '1495192630 3' 9-max Seat #2 is the button
Seat 1: Fischersito (11325 in chips)
Seat 2: Thore H (5052 in chips)
Seat 3: Irisha2 (19280 in chips)
Seat 4: DmelloH (14049 in chips)
Seat 9: held (17794 in chips)
Fischersito: posts the ante 50
Thore H: posts the ante 50
Irisha2: posts the ante 50
DmelloH: posts the ante 50
held: posts the ante 50
Irisha2: posts small blind 300
DmelloH: posts big blind 600
*** HOLE CARDS ***
Dealt to held [5s 6h]
held: folds
Fischersito: folds
Thore H: raises 4402 to 5002 and is all-in
Irisha2: folds
DmelloH: folds
Uncalled bet (4402) returned to Thore H
Thore H collected 1750 from pot
*** SUMMARY ***
Total pot 1750 | Rake 0
Seat 1: Fischersito folded before Flop (didn't bet)
Seat 2: Thore H (button) collected (1750)
Seat 3: Irisha2 (small blind) folded before Flop
Seat 4: DmelloH (big blind) folded before Flop
Seat 9: held folded before Flop (didn't bet)


*********** # 25 **************
PokerStars Hand #149651873405: Tournament #1495192630, $0.91+$0.09 USD Hold'em No Limit - Level X (300/600) - 2016/03/01 1:22:12 ET
Table '1495192630 3' 9-max Seat #1 is the button
Seat 1: Fischersito (11375 in chips)
Seat 2: Thore H (5402 in chips)
Seat 3: Irisha2 (19930 in chips)
Seat 4: DmelloH (14099 in chips)
Seat 9: held (16694 in chips)
Fischersito: posts the ante 50
Thore H: posts the ante 50
Irisha2: posts the ante 50
DmelloH: posts the ante 50
held: posts the ante 50
Thore H: posts small blind 300
Irisha2: posts big blind 600
*** HOLE CARDS ***
Dealt to held [Jd Ad]
DmelloH: folds
held: raises 1066 to 1666
Fischersito: folds
Thore H: folds
Irisha2: folds
Uncalled bet (1066) returned to held
held collected 1750 from pot
held: doesn't show hand
*** SUMMARY ***
Total pot 1750 | Rake 0
Seat 1: Fischersito (button) folded before Flop (didn't bet)
Seat 2: Thore H (small blind) folded before Flop
Seat 3: Irisha2 (big blind) folded before Flop
Seat 4: DmelloH folded before Flop (didn't bet)
Seat 9: held collected (1750)


*********** # 26 **************
PokerStars Hand #149651865486: Tournament #1495192630, $0.91+$0.09 USD Hold'em No Limit - Level X (300/600) - 2016/03/01 1:21:42 ET
Table '1495192630 3' 9-max Seat #9 is the button
Seat 1: Fischersito (8775 in chips)
Seat 2: Thore H (7852 in chips)
Seat 3: Irisha2 (19980 in chips)
Seat 4: DmelloH (14149 in chips)
Seat 9: held (16744 in chips)
Fischersito: posts the ante 50
Thore H: posts the ante 50
Irisha2: posts the ante 50
DmelloH: posts the ante 50
held: posts the ante 50
Fischersito: posts small blind 300
Thore H: posts big blind 600
*** HOLE CARDS ***
Dealt to held [Jc 5d]
Irisha2: folds
DmelloH: folds
held: folds
Fischersito: raises 600 to 1200
Thore H: calls 600
*** FLOP *** [9c Jd 4d]
Fischersito: bets 1200
Thore H: calls 1200
*** TURN *** [9c Jd 4d] [Ad]
Fischersito: bets 6325 and is all-in
Thore H: folds
Uncalled bet (6325) returned to Fischersito
Fischersito collected 5050 from pot
Fischersito: doesn't show hand
*** SUMMARY ***
Total pot 5050 | Rake 0
Board [9c Jd 4d Ad]
Seat 1: Fischersito (small blind) collected (5050)
Seat 2: Thore H (big blind) folded on the Turn
Seat 3: Irisha2 folded before Flop (didn't bet)
Seat 4: DmelloH folded before Flop (didn't bet)
Seat 9: held (button) folded before Flop (didn't bet)


*********** # 27 **************
PokerStars Hand #149651857513: Tournament #1495192630, $0.91+$0.09 USD Hold'em No Limit - Level X (300/600) - 2016/03/01 1:21:12 ET
Table '1495192630 3' 9-max Seat #4 is the button
Seat 1: Fischersito (8825 in chips)
Seat 2: Thore H (7902 in chips)
Seat 3: Irisha2 (20030 in chips)
Seat 4: DmelloH (6923 in chips)
Seat 7: sapinho1001 (6426 in chips)
Seat 9: held (17394 in chips)
Fischersito: posts the ante 50
Thore H: posts the ante 50
Irisha2: posts the ante 50
DmelloH: posts the ante 50
sapinho1001: posts the ante 50
held: posts the ante 50
sapinho1001: posts small blind 300
held: posts big blind 600
*** HOLE CARDS ***
Dealt to held [Kh 5h]
Fischersito: folds
Thore H: folds
Irisha2: folds
DmelloH: raises 600 to 1200
sapinho1001: raises 5176 to 6376 and is all-in
held: folds
DmelloH: calls 5176
*** FLOP *** [3c 9s 2c]
*** TURN *** [3c 9s 2c] [6d]
*** RIVER *** [3c 9s 2c 6d] [3s]
*** SHOW DOWN ***
sapinho1001: shows [Ac Qc] (a pair of Threes)
DmelloH: shows [As 9d] (two pair, Nines and Threes)
DmelloH collected 13652 from pot
sapinho1001 finished the tournament in 6th place and received $2.45.
*** SUMMARY ***
Total pot 13652 | Rake 0
Board [3c 9s 2c 6d 3s]
Seat 1: Fischersito folded before Flop (didn't bet)
Seat 2: Thore H folded before Flop (didn't bet)
Seat 3: Irisha2 folded before Flop (didn't bet)
Seat 4: DmelloH (button) showed [As 9d] and won (13652) with two pair, Nines and Threes
Seat 7: sapinho1001 (small blind) showed [Ac Qc] and lost with a pair of Threes
Seat 9: held (big blind) folded before Flop


*********** # 28 **************
PokerStars Hand #149651845200: Tournament #1495192630, $0.91+$0.09 USD Hold'em No Limit - Level X (300/600) - 2016/03/01 1:20:25 ET
Table '1495192630 3' 9-max Seat #3 is the button
Seat 1: Fischersito (8875 in chips)
Seat 2: Thore H (7952 in chips)
Seat 3: Irisha2 (20080 in chips)
Seat 4: DmelloH (10036 in chips)
Seat 7: sapinho1001 (3113 in chips)
Seat 9: held (17444 in chips)
Fischersito: posts the ante 50
Thore H: posts the ante 50
Irisha2: posts the ante 50
DmelloH: posts the ante 50
sapinho1001: posts the ante 50
held: posts the ante 50
DmelloH: posts small blind 300
sapinho1001: posts big blind 600
*** HOLE CARDS ***
Dealt to held [Qc 7s]
held: folds
Fischersito: folds
Thore H: folds
Irisha2: folds
DmelloH: raises 1200 to 1800
sapinho1001: raises 1263 to 3063 and is all-in
DmelloH: calls 1263
*** FLOP *** [Kh 6h 3h]
*** TURN *** [Kh 6h 3h] [3c]
*** RIVER *** [Kh 6h 3h 3c] [5d]
*** SHOW DOWN ***
DmelloH: shows [Jc As] (a pair of Threes)
sapinho1001: shows [9h Kd] (two pair, Kings and Threes)
sapinho1001 collected 6426 from pot
*** SUMMARY ***
Total pot 6426 | Rake 0
Board [Kh 6h 3h 3c 5d]
Seat 1: Fischersito folded before Flop (didn't bet)
Seat 2: Thore H folded before Flop (didn't bet)
Seat 3: Irisha2 (button) folded before Flop (didn't bet)
Seat 4: DmelloH (small blind) showed [Jc As] and lost with a pair of Threes
Seat 7: sapinho1001 (big blind) showed [9h Kd] and won (6426) with two pair, Kings and Threes
Seat 9: held folded before Flop (didn't bet)


*********** # 29 **************
PokerStars Hand #149651836462: Tournament #1495192630, $0.91+$0.09 USD Hold'em No Limit - Level X (300/600) - 2016/03/01 1:19:52 ET
Table '1495192630 3' 9-max Seat #2 is the button
Seat 1: Fischersito (8925 in chips)
Seat 2: Thore H (8002 in chips)
Seat 3: Irisha2 (19230 in chips)
Seat 4: DmelloH (10686 in chips)
Seat 7: sapinho1001 (3163 in chips)
Seat 9: held (17494 in chips)
Fischersito: posts the ante 50
Thore H: posts the ante 50
Irisha2: posts the ante 50
DmelloH: posts the ante 50
sapinho1001: posts the ante 50
held: posts the ante 50
Irisha2: posts small blind 300
DmelloH: posts big blind 600
*** HOLE CARDS ***
Dealt to held [Qs 5h]
sapinho1001: folds
held: folds
Fischersito: folds
Thore H: folds
Irisha2: raises 1200 to 1800
DmelloH: folds [7s 3c]
Uncalled bet (1200) returned to Irisha2
Irisha2 collected 1500 from pot
Irisha2: doesn't show hand
*** SUMMARY ***
Total pot 1500 | Rake 0
Seat 1: Fischersito folded before Flop (didn't bet)
Seat 2: Thore H (button) folded before Flop (didn't bet)
Seat 3: Irisha2 (small blind) collected (1500)
Seat 4: DmelloH (big blind) folded before Flop
Seat 7: sapinho1001 folded before Flop (didn't bet)
Seat 9: held folded before Flop (didn't bet)


*********** # 30 **************
PokerStars Hand #149651828360: Tournament #1495192630, $0.91+$0.09 USD Hold'em No Limit - Level X (300/600) - 2016/03/01 1:19:20 ET
Table '1495192630 3' 9-max Seat #1 is the button
Seat 1: Fischersito (8975 in chips)
Seat 2: Thore H (7152 in chips)
Seat 3: Irisha2 (19880 in chips)
Seat 4: DmelloH (10736 in chips)
Seat 7: sapinho1001 (3213 in chips)
Seat 9: held (17544 in chips)
Fischersito: posts the ante 50
Thore H: posts the ante 50
Irisha2: posts the ante 50
DmelloH: posts the ante 50
sapinho1001: posts the ante 50
held: posts the ante 50
Thore H: posts small blind 300
Irisha2: posts big blind 600
*** HOLE CARDS ***
Dealt to held [7c Tc]
sapinho1001 said, ":("
DmelloH: folds
sapinho1001: folds
held: folds
Fischersito: folds
Thore H: raises 6502 to 7102 and is all-in
Irisha2: folds
Uncalled bet (6502) returned to Thore H
Thore H collected 1500 from pot
*** SUMMARY ***
Total pot 1500 | Rake 0
Seat 1: Fischersito (button) folded before Flop (didn't bet)
Seat 2: Thore H (small blind) collected (1500)
Seat 3: Irisha2 (big blind) folded before Flop
Seat 4: DmelloH folded before Flop (didn't bet)
Seat 7: sapinho1001 folded before Flop (didn't bet)
Seat 9: held folded before Flop (didn't bet)


*********** # 31 **************
PokerStars Hand #149651819511: Tournament #1495192630, $0.91+$0.09 USD Hold'em No Limit - Level X (300/600) - 2016/03/01 1:18:46 ET
Table '1495192630 3' 9-max Seat #9 is the button
Seat 1: Fischersito (8875 in chips)
Seat 2: Thore H (7052 in chips)
Seat 3: Irisha2 (19930 in chips)
Seat 4: DmelloH (10786 in chips)
Seat 7: sapinho1001 (3263 in chips)
Seat 9: held (17594 in chips)
Fischersito: posts the ante 50
Thore H: posts the ante 50
Irisha2: posts the ante 50
DmelloH: posts the ante 50
sapinho1001: posts the ante 50
held: posts the ante 50
Fischersito: posts small blind 300
Thore H: posts big blind 600
*** HOLE CARDS ***
Dealt to held [Jd 9d]
Thore H said, "..i.."
Irisha2: folds
DmelloH: folds
sapinho1001: folds
held: folds
Fischersito: raises 8225 to 8825 and is all-in
Thore H: calls 6402 and is all-in
Uncalled bet (1823) returned to Fischersito
*** FLOP *** [5s 2h 7c]
*** TURN *** [5s 2h 7c] [5h]
*** RIVER *** [5s 2h 7c 5h] [Kh]
*** SHOW DOWN ***
Fischersito: shows [Kd Jc] (two pair, Kings and Fives)
Thore H: shows [Js Kc] (two pair, Kings and Fives)
Fischersito collected 7152 from pot
Thore H collected 7152 from pot
*** SUMMARY ***
Total pot 14304 | Rake 0
Board [5s 2h 7c 5h Kh]
Seat 1: Fischersito (small blind) showed [Kd Jc] and won (7152) with two pair, Kings and Fives
Seat 2: Thore H (big blind) showed [Js Kc] and won (7152) with two pair, Kings and Fives
Seat 3: Irisha2 folded before Flop (didn't bet)
Seat 4: DmelloH folded before Flop (didn't bet)
Seat 7: sapinho1001 folded before Flop (didn't bet)
Seat 9: held (button) folded before Flop (didn't bet)


*********** # 32 **************
PokerStars Hand #149651812794: Tournament #1495192630, $0.91+$0.09 USD Hold'em No Limit - Level X (300/600) - 2016/03/01 1:18:20 ET
Table '1495192630 3' 9-max Seat #7 is the button
Seat 1: Fischersito (9525 in chips)
Seat 2: Thore H (2976 in chips)
Seat 3: Irisha2 (19980 in chips)
Seat 4: DmelloH (10836 in chips)
Seat 7: sapinho1001 (6239 in chips)
Seat 9: held (17944 in chips)
Fischersito: posts the ante 50
Thore H: posts the ante 50
Irisha2: posts the ante 50
DmelloH: posts the ante 50
sapinho1001: posts the ante 50
held: posts the ante 50
held: posts small blind 300
Fischersito: posts big blind 600
*** HOLE CARDS ***
Dealt to held [6c 5s]
Thore H: raises 2326 to 2926 and is all-in
Irisha2: folds
DmelloH: folds
sapinho1001: raises 3263 to 6189 and is all-in
held: folds
Fischersito: folds
Uncalled bet (3263) returned to sapinho1001
*** FLOP *** [8h 3h Kc]
*** TURN *** [8h 3h Kc] [9d]
*** RIVER *** [8h 3h Kc 9d] [5h]
*** SHOW DOWN ***
Thore H: shows [9h Th] (a flush, Ten high)
sapinho1001: shows [Js Qd] (high card King)
Thore H collected 7052 from pot
*** SUMMARY ***
Total pot 7052 | Rake 0
Board [8h 3h Kc 9d 5h]
Seat 1: Fischersito (big blind) folded before Flop
Seat 2: Thore H showed [9h Th] and won (7052) with a flush, Ten high
Seat 3: Irisha2 folded before Flop (didn't bet)
Seat 4: DmelloH folded before Flop (didn't bet)
Seat 7: sapinho1001 (button) showed [Js Qd] and lost with high card King
Seat 9: held (small blind) folded before Flop


*********** # 33 **************
PokerStars Hand #149651806838: Tournament #1495192630, $0.91+$0.09 USD Hold'em No Limit - Level X (300/600) - 2016/03/01 1:17:58 ET
Table '1495192630 3' 9-max Seat #4 is the button
Seat 1: Fischersito (9575 in chips)
Seat 2: Thore H (1238 in chips)
Seat 3: Irisha2 (20030 in chips)
Seat 4: DmelloH (10886 in chips)
Seat 7: sapinho1001 (6589 in chips)
Seat 9: held (19182 in chips)
Fischersito: posts the ante 50
Thore H: posts the ante 50
Irisha2: posts the ante 50
DmelloH: posts the ante 50
sapinho1001: posts the ante 50
held: posts the ante 50
sapinho1001: posts small blind 300
held: posts big blind 600
*** HOLE CARDS ***
Dealt to held [9c 6h]
Fischersito: folds
Thore H: raises 588 to 1188 and is all-in
Irisha2: folds
DmelloH: folds
sapinho1001: folds
held: calls 588
*** FLOP *** [5s 6s 7c]
*** TURN *** [5s 6s 7c] [As]
*** RIVER *** [5s 6s 7c As] [5d]
*** SHOW DOWN ***
held: shows [9c 6h] (two pair, Sixes and Fives)
Thore H: shows [Ah 3d] (two pair, Aces and Fives)
Thore H collected 2976 from pot
Thore H said, "nh  w anker"
*** SUMMARY ***
Total pot 2976 | Rake 0
Board [5s 6s 7c As 5d]
Seat 1: Fischersito folded before Flop (didn't bet)
Seat 2: Thore H showed [Ah 3d] and won (2976) with two pair, Aces and Fives
Seat 3: Irisha2 folded before Flop (didn't bet)
Seat 4: DmelloH (button) folded before Flop (didn't bet)
Seat 7: sapinho1001 (small blind) folded before Flop
Seat 9: held (big blind) showed [9c 6h] and lost with two pair, Sixes and Fives


*********** # 34 **************
PokerStars Hand #149651795996: Tournament #1495192630, $0.91+$0.09 USD Hold'em No Limit - Level X (300/600) - 2016/03/01 1:17:16 ET
Table '1495192630 3' 9-max Seat #3 is the button
Seat 1: Fischersito (9625 in chips)
Seat 2: Thore H (6281 in chips)
Seat 3: Irisha2 (20080 in chips)
Seat 4: DmelloH (5043 in chips)
Seat 7: sapinho1001 (7239 in chips)
Seat 9: held (19232 in chips)
Fischersito: posts the ante 50
Thore H: posts the ante 50
Irisha2: posts the ante 50
DmelloH: posts the ante 50
sapinho1001: posts the ante 50
held: posts the ante 50
DmelloH: posts small blind 300
sapinho1001: posts big blind 600
*** HOLE CARDS ***
Dealt to held [7s 8d]
held: folds
Fischersito: folds
Thore H: raises 5631 to 6231 and is all-in
Irisha2: folds
DmelloH: calls 4693 and is all-in
sapinho1001: folds
Uncalled bet (1238) returned to Thore H
*** FLOP *** [5d 3s Qd]
*** TURN *** [5d 3s Qd] [6d]
*** RIVER *** [5d 3s Qd 6d] [Qh]
*** SHOW DOWN ***
DmelloH: shows [Kd Qs] (three of a kind, Queens)
Thore H: shows [2h Ad] (a pair of Queens)
DmelloH collected 10886 from pot
*** SUMMARY ***
Total pot 10886 | Rake 0
Board [5d 3s Qd 6d Qh]
Seat 1: Fischersito folded before Flop (didn't bet)
Seat 2: Thore H showed [2h Ad] and lost with a pair of Queens
Seat 3: Irisha2 (button) folded before Flop (didn't bet)
Seat 4: DmelloH (small blind) showed [Kd Qs] and won (10886) with three of a kind, Queens
Seat 7: sapinho1001 (big blind) folded before Flop
Seat 9: held folded before Flop (didn't bet)


*********** # 35 **************
PokerStars Hand #149651785759: Tournament #1495192630, $0.91+$0.09 USD Hold'em No Limit - Level X (300/600) - 2016/03/01 1:16:36 ET
Table '1495192630 3' 9-max Seat #2 is the button
Seat 1: Fischersito (9675 in chips)
Seat 2: Thore H (7886 in chips)
Seat 3: Irisha2 (20430 in chips)
Seat 4: DmelloH (5693 in chips)
Seat 7: sapinho1001 (7289 in chips)
Seat 9: held (16527 in chips)
Fischersito: posts the ante 50
Thore H: posts the ante 50
Irisha2: posts the ante 50
DmelloH: posts the ante 50
sapinho1001: posts the ante 50
held: posts the ante 50
Irisha2: posts small blind 300
DmelloH: posts big blind 600
*** HOLE CARDS ***
Dealt to held [Jc Jd]
sapinho1001: folds
held: raises 955 to 1555
Fischersito: folds
Thore H: calls 1555
Irisha2: folds
DmelloH: folds
*** FLOP *** [Qs 3d 6c]
held: bets 3333
Thore H: folds
Uncalled bet (3333) returned to held
held collected 4310 from pot
*** SUMMARY ***
Total pot 4310 | Rake 0
Board [Qs 3d 6c]
Seat 1: Fischersito folded before Flop (didn't bet)
Seat 2: Thore H (button) folded on the Flop
Seat 3: Irisha2 (small blind) folded before Flop
Seat 4: DmelloH (big blind) folded before Flop
Seat 7: sapinho1001 folded before Flop (didn't bet)
Seat 9: held collected (4310)


*********** # 36 **************
PokerStars Hand #149651782063: Tournament #1495192630, $0.91+$0.09 USD Hold'em No Limit - Level X (300/600) - 2016/03/01 1:16:23 ET
Table '1495192630 3' 9-max Seat #1 is the button
Seat 1: Fischersito (9725 in chips)
Seat 2: Thore H (8236 in chips)
Seat 3: Irisha2 (21080 in chips)
Seat 4: DmelloH (4543 in chips)
Seat 7: sapinho1001 (7339 in chips)
Seat 9: held (16577 in chips)
Fischersito: posts the ante 50
Thore H: posts the ante 50
Irisha2: posts the ante 50
DmelloH: posts the ante 50
sapinho1001: posts the ante 50
held: posts the ante 50
Thore H: posts small blind 300
Irisha2: posts big blind 600
*** HOLE CARDS ***
Dealt to held [5h Qc]
DmelloH: raises 3893 to 4493 and is all-in
sapinho1001: folds
held: folds
Fischersito: folds
Thore H: folds
Irisha2: folds
Uncalled bet (3893) returned to DmelloH
DmelloH collected 1800 from pot
DmelloH: doesn't show hand
*** SUMMARY ***
Total pot 1800 | Rake 0
Seat 1: Fischersito (button) folded before Flop (didn't bet)
Seat 2: Thore H (small blind) folded before Flop
Seat 3: Irisha2 (big blind) folded before Flop
Seat 4: DmelloH collected (1800)
Seat 7: sapinho1001 folded before Flop (didn't bet)
Seat 9: held folded before Flop (didn't bet)


*********** # 37 **************
PokerStars Hand #149651770677: Tournament #1495192630, $0.91+$0.09 USD Hold'em No Limit - Level X (300/600) - 2016/03/01 1:15:39 ET
Table '1495192630 3' 9-max Seat #9 is the button
Seat 1: Fischersito (10075 in chips)
Seat 2: Thore H (8886 in chips)
Seat 3: Irisha2 (21130 in chips)
Seat 4: DmelloH (5193 in chips)
Seat 7: sapinho1001 (5589 in chips)
Seat 9: held (16627 in chips)
Fischersito: posts the ante 50
Thore H: posts the ante 50
Irisha2: posts the ante 50
DmelloH: posts the ante 50
sapinho1001: posts the ante 50
held: posts the ante 50
Fischersito: posts small blind 300
Thore H: posts big blind 600
*** HOLE CARDS ***
Dealt to held [Ks 5h]
Irisha2: folds
DmelloH: calls 600
sapinho1001: raises 4939 to 5539 and is all-in
held: folds
Fischersito: folds
Thore H: folds
DmelloH: folds
Uncalled bet (4939) returned to sapinho1001
sapinho1001 collected 2400 from pot
sapinho1001: doesn't show hand
*** SUMMARY ***
Total pot 2400 | Rake 0
Seat 1: Fischersito (small blind) folded before Flop
Seat 2: Thore H (big blind) folded before Flop
Seat 3: Irisha2 folded before Flop (didn't bet)
Seat 4: DmelloH folded before Flop
Seat 7: sapinho1001 collected (2400)
Seat 9: held (button) folded before Flop (didn't bet)


*********** # 38 **************
PokerStars Hand #149651762906: Tournament #1495192630, $0.91+$0.09 USD Hold'em No Limit - Level IX (200/400) - 2016/03/01 1:15:09 ET
Table '1495192630 3' 9-max Seat #7 is the button
Seat 1: Fischersito (10500 in chips)
Seat 2: Thore H (8911 in chips)
Seat 3: Irisha2 (21155 in chips)
Seat 4: DmelloH (5218 in chips)
Seat 7: sapinho1001 (4864 in chips)
Seat 9: held (16852 in chips)
Fischersito: posts the ante 25
Thore H: posts the ante 25
Irisha2: posts the ante 25
DmelloH: posts the ante 25
sapinho1001: posts the ante 25
held: posts the ante 25
held: posts small blind 200
Fischersito: posts big blind 400
*** HOLE CARDS ***
Dealt to held [4s Jc]
Thore H: folds
Irisha2: folds
DmelloH: folds
sapinho1001: raises 4439 to 4839 and is all-in
held: folds
Fischersito: folds
Uncalled bet (4439) returned to sapinho1001
sapinho1001 collected 1150 from pot
sapinho1001: doesn't show hand
*** SUMMARY ***
Total pot 1150 | Rake 0
Seat 1: Fischersito (big blind) folded before Flop
Seat 2: Thore H folded before Flop (didn't bet)
Seat 3: Irisha2 folded before Flop (didn't bet)
Seat 4: DmelloH folded before Flop (didn't bet)
Seat 7: sapinho1001 (button) collected (1150)
Seat 9: held (small blind) folded before Flop


*********** # 39 **************
PokerStars Hand #149651749145: Tournament #1495192630, $0.91+$0.09 USD Hold'em No Limit - Level IX (200/400) - 2016/03/01 1:14:17 ET
Table '1495192630 3' 9-max Seat #4 is the button
Seat 1: Fischersito (6770 in chips)
Seat 2: Thore H (8936 in chips)
Seat 3: Irisha2 (21180 in chips)
Seat 4: DmelloH (5243 in chips)
Seat 5: Zanussof (3205 in chips)
Seat 7: sapinho1001 (5289 in chips)
Seat 9: held (16877 in chips)
Fischersito: posts the ante 25
Thore H: posts the ante 25
Irisha2: posts the ante 25
DmelloH: posts the ante 25
Zanussof: posts the ante 25
sapinho1001: posts the ante 25
held: posts the ante 25
Zanussof: posts small blind 200
sapinho1001: posts big blind 400
*** HOLE CARDS ***
Dealt to held [7h Qh]
held: folds
Fischersito: raises 800 to 1200
Thore H: folds
Irisha2: folds
DmelloH: folds
Zanussof: raises 1980 to 3180 and is all-in
sapinho1001: folds
Fischersito: calls 1980
*** FLOP *** [Jh Ts 5d]
*** TURN *** [Jh Ts 5d] [Th]
*** RIVER *** [Jh Ts 5d Th] [Qd]
*** SHOW DOWN ***
Zanussof: shows [Ac Js] (two pair, Jacks and Tens)
Fischersito: shows [Tc 9c] (three of a kind, Tens)
Fischersito collected 6935 from pot
Zanussof finished the tournament in 7th place and received $1.43.
*** SUMMARY ***
Total pot 6935 | Rake 0
Board [Jh Ts 5d Th Qd]
Seat 1: Fischersito showed [Tc 9c] and won (6935) with three of a kind, Tens
Seat 2: Thore H folded before Flop (didn't bet)
Seat 3: Irisha2 folded before Flop (didn't bet)
Seat 4: DmelloH (button) folded before Flop (didn't bet)
Seat 5: Zanussof (small blind) showed [Ac Js] and lost with two pair, Jacks and Tens
Seat 7: sapinho1001 (big blind) folded before Flop
Seat 9: held folded before Flop (didn't bet)


*********** # 40 **************
PokerStars Hand #149651743214: Tournament #1495192630, $0.91+$0.09 USD Hold'em No Limit - Level IX (200/400) - 2016/03/01 1:13:54 ET
Table '1495192630 3' 9-max Seat #3 is the button
Seat 1: Fischersito (6795 in chips)
Seat 2: Thore H (8186 in chips)
Seat 3: Irisha2 (21205 in chips)
Seat 4: DmelloH (5468 in chips)
Seat 5: Zanussof (3630 in chips)
Seat 7: sapinho1001 (5314 in chips)
Seat 9: held (16902 in chips)
Fischersito: posts the ante 25
Thore H: posts the ante 25
Irisha2: posts the ante 25
DmelloH: posts the ante 25
Zanussof: posts the ante 25
sapinho1001: posts the ante 25
held: posts the ante 25
DmelloH: posts small blind 200
Zanussof: posts big blind 400
*** HOLE CARDS ***
Dealt to held [Th Kd]
sapinho1001: folds
held: folds
Fischersito: folds
Thore H: raises 400 to 800
Irisha2: folds
DmelloH: folds
Zanussof: folds
Uncalled bet (400) returned to Thore H
Thore H collected 1175 from pot
*** SUMMARY ***
Total pot 1175 | Rake 0
Seat 1: Fischersito folded before Flop (didn't bet)
Seat 2: Thore H collected (1175)
Seat 3: Irisha2 (button) folded before Flop (didn't bet)
Seat 4: DmelloH (small blind) folded before Flop
Seat 5: Zanussof (big blind) folded before Flop
Seat 7: sapinho1001 folded before Flop (didn't bet)
Seat 9: held folded before Flop (didn't bet)


*********** # 41 **************
PokerStars Hand #149651738024: Tournament #1495192630, $0.91+$0.09 USD Hold'em No Limit - Level IX (200/400) - 2016/03/01 1:13:35 ET
Table '1495192630 3' 9-max Seat #2 is the button
Seat 1: Fischersito (6820 in chips)
Seat 2: Thore H (8211 in chips)
Seat 3: Irisha2 (21430 in chips)
Seat 4: DmelloH (5118 in chips)
Seat 5: Zanussof (3655 in chips)
Seat 7: sapinho1001 (5339 in chips)
Seat 9: held (16927 in chips)
Fischersito: posts the ante 25
Thore H: posts the ante 25
Irisha2: posts the ante 25
DmelloH: posts the ante 25
Zanussof: posts the ante 25
sapinho1001: posts the ante 25
held: posts the ante 25
Irisha2: posts small blind 200
DmelloH: posts big blind 400
*** HOLE CARDS ***
Dealt to held [3s 9d]
Zanussof: folds
sapinho1001: folds
held: folds
Fischersito: folds
Thore H: folds
Irisha2: folds
Uncalled bet (200) returned to DmelloH
DmelloH collected 575 from pot
DmelloH: doesn't show hand
*** SUMMARY ***
Total pot 575 | Rake 0
Seat 1: Fischersito folded before Flop (didn't bet)
Seat 2: Thore H (button) folded before Flop (didn't bet)
Seat 3: Irisha2 (small blind) folded before Flop
Seat 4: DmelloH (big blind) collected (575)
Seat 5: Zanussof folded before Flop (didn't bet)
Seat 7: sapinho1001 folded before Flop (didn't bet)
Seat 9: held folded before Flop (didn't bet)


*********** # 42 **************
PokerStars Hand #149651728008: Tournament #1495192630, $0.91+$0.09 USD Hold'em No Limit - Level IX (200/400) - 2016/03/01 1:12:56 ET
Table '1495192630 3' 9-max Seat #1 is the button
Seat 1: Fischersito (6845 in chips)
Seat 2: Thore H (8436 in chips)
Seat 3: Irisha2 (21855 in chips)
Seat 4: DmelloH (5143 in chips)
Seat 5: Zanussof (3680 in chips)
Seat 7: sapinho1001 (4589 in chips)
Seat 9: held (16952 in chips)
Fischersito: posts the ante 25
Thore H: posts the ante 25
Irisha2: posts the ante 25
DmelloH: posts the ante 25
Zanussof: posts the ante 25
sapinho1001: posts the ante 25
held: posts the ante 25
Thore H: posts small blind 200
Irisha2: posts big blind 400
*** HOLE CARDS ***
Dealt to held [Ah 8c]
Irisha2 said, "&&&&"
DmelloH: folds
Zanussof: folds
Thore H said, "hope u die fast"
Irisha2 said, "????????????"
sapinho1001: raises 800 to 1200
held: folds
Fischersito: folds
Thore H: folds
Irisha2: folds
Uncalled bet (800) returned to sapinho1001
sapinho1001 collected 1175 from pot
sapinho1001: doesn't show hand
*** SUMMARY ***
Total pot 1175 | Rake 0
Seat 1: Fischersito (button) folded before Flop (didn't bet)
Seat 2: Thore H (small blind) folded before Flop
Seat 3: Irisha2 (big blind) folded before Flop
Seat 4: DmelloH folded before Flop (didn't bet)
Seat 5: Zanussof folded before Flop (didn't bet)
Seat 7: sapinho1001 collected (1175)
Seat 9: held folded before Flop (didn't bet)


*********** # 43 **************
PokerStars Hand #149651722267: Tournament #1495192630, $0.91+$0.09 USD Hold'em No Limit - Level IX (200/400) - 2016/03/01 1:12:34 ET
Table '1495192630 3' 9-max Seat #9 is the button
Seat 1: Fischersito (7070 in chips)
Seat 2: Thore H (8861 in chips)
Seat 3: Irisha2 (21880 in chips)
Seat 4: DmelloH (5168 in chips)
Seat 5: Zanussof (3705 in chips)
Seat 7: sapinho1001 (3839 in chips)
Seat 9: held (16977 in chips)
Fischersito: posts the ante 25
Thore H: posts the ante 25
Irisha2: posts the ante 25
DmelloH: posts the ante 25
Zanussof: posts the ante 25
sapinho1001: posts the ante 25
held: posts the ante 25
Fischersito: posts small blind 200
Thore H: posts big blind 400
*** HOLE CARDS ***
Dealt to held [Ad 9h]
Irisha2: folds
DmelloH: folds
Zanussof: folds
Thore H said, "russian  b astard"
sapinho1001: raises 3414 to 3814 and is all-in
held: folds
Fischersito: folds
Thore H: folds
Uncalled bet (3414) returned to sapinho1001
sapinho1001 collected 1175 from pot
sapinho1001: doesn't show hand
*** SUMMARY ***
Total pot 1175 | Rake 0
Seat 1: Fischersito (small blind) folded before Flop
Seat 2: Thore H (big blind) folded before Flop
Seat 3: Irisha2 folded before Flop (didn't bet)
Seat 4: DmelloH folded before Flop (didn't bet)
Seat 5: Zanussof folded before Flop (didn't bet)
Seat 7: sapinho1001 collected (1175)
Seat 9: held (button) folded before Flop (didn't bet)


*********** # 44 **************
PokerStars Hand #149651707278: Tournament #1495192630, $0.91+$0.09 USD Hold'em No Limit - Level IX (200/400) - 2016/03/01 1:11:36 ET
Table '1495192630 3' 9-max Seat #7 is the button
Seat 1: Fischersito (7495 in chips)
Seat 2: Thore H (19085 in chips)
Seat 3: Irisha2 (10224 in chips)
Seat 4: DmelloH (5193 in chips)
Seat 5: Zanussof (3730 in chips)
Seat 6: morena211 (707 in chips)
Seat 7: sapinho1001 (3864 in chips)
Seat 9: held (17202 in chips)
Fischersito: posts the ante 25
Thore H: posts the ante 25
Irisha2: posts the ante 25
DmelloH: posts the ante 25
Zanussof: posts the ante 25
morena211: posts the ante 25
sapinho1001: posts the ante 25
held: posts the ante 25
held: posts small blind 200
Fischersito: posts big blind 400
*** HOLE CARDS ***
Dealt to held [Kd 9h]
Thore H: raises 400 to 800
Irisha2: raises 800 to 1600
DmelloH: folds
Zanussof: folds
morena211: calls 682 and is all-in
sapinho1001: folds
held: folds
Fischersito: folds
Thore H: calls 800
*** FLOP *** [As Qs 5h]
Thore H: checks
Irisha2: bets 1600
Thore H: calls 1600
*** TURN *** [As Qs 5h] [8c]
Thore H: checks
Irisha2: bets 2800
Thore H: calls 2800
*** RIVER *** [As Qs 5h 8c] [Qc]
Thore H: bets 13060 and is all-in
Irisha2: calls 4199 and is all-in
Uncalled bet (8861) returned to Thore H
*** SHOW DOWN ***
Thore H: shows [Ac Th] (two pair, Aces and Queens)
Irisha2: shows [Ah Qh] (a full house, Queens full of Aces)
Irisha2 collected 19034 from side pot
morena211: shows [6h 6c] (two pair, Queens and Sixes)
Irisha2 collected 2846 from main pot
morena211 finished the tournament in 8th place
*** SUMMARY ***
Total pot 21880 Main pot 2846. Side pot 19034. | Rake 0
Board [As Qs 5h 8c Qc]
Seat 1: Fischersito (big blind) folded before Flop
Seat 2: Thore H showed [Ac Th] and lost with two pair, Aces and Queens
Seat 3: Irisha2 showed [Ah Qh] and won (21880) with a full house, Queens full of Aces
Seat 4: DmelloH folded before Flop (didn't bet)
Seat 5: Zanussof folded before Flop (didn't bet)
Seat 6: morena211 showed [6h 6c] and lost with two pair, Queens and Sixes
Seat 7: sapinho1001 (button) folded before Flop (didn't bet)
Seat 9: held (small blind) folded before Flop


*********** # 45 **************
PokerStars Hand #149651699619: Tournament #1495192630, $0.91+$0.09 USD Hold'em No Limit - Level IX (200/400) - 2016/03/01 1:11:07 ET
Table '1495192630 3' 9-max Seat #6 is the button
Seat 1: Fischersito (6720 in chips)
Seat 2: Thore H (19110 in chips)
Seat 3: Irisha2 (10249 in chips)
Seat 4: DmelloH (5218 in chips)
Seat 5: Zanussof (3755 in chips)
Seat 6: morena211 (732 in chips)
Seat 7: sapinho1001 (4089 in chips)
Seat 9: held (17627 in chips)
Fischersito: posts the ante 25
Thore H: posts the ante 25
Irisha2: posts the ante 25
DmelloH: posts the ante 25
Zanussof: posts the ante 25
morena211: posts the ante 25
sapinho1001: posts the ante 25
held: posts the ante 25
sapinho1001: posts small blind 200
held: posts big blind 400
*** HOLE CARDS ***
Dealt to held [9d Ah]
Fischersito: raises 800 to 1200
Thore H: folds
Irisha2: folds
DmelloH: folds
Zanussof: folds
morena211: folds
sapinho1001: folds
held: folds
Uncalled bet (800) returned to Fischersito
Fischersito collected 1200 from pot
Fischersito: doesn't show hand
*** SUMMARY ***
Total pot 1200 | Rake 0
Seat 1: Fischersito collected (1200)
Seat 2: Thore H folded before Flop (didn't bet)
Seat 3: Irisha2 folded before Flop (didn't bet)
Seat 4: DmelloH folded before Flop (didn't bet)
Seat 5: Zanussof folded before Flop (didn't bet)
Seat 6: morena211 (button) folded before Flop (didn't bet)
Seat 7: sapinho1001 (small blind) folded before Flop
Seat 9: held (big blind) folded before Flop


*********** # 46 **************
PokerStars Hand #149651691265: Tournament #1495192630, $0.91+$0.09 USD Hold'em No Limit - Level IX (200/400) - 2016/03/01 1:10:35 ET
Table '1495192630 3' 9-max Seat #5 is the button
Seat 1: Fischersito (6745 in chips)
Seat 2: Thore H (19135 in chips)
Seat 3: Irisha2 (10274 in chips)
Seat 4: DmelloH (5243 in chips)
Seat 5: Zanussof (3780 in chips)
Seat 6: morena211 (1157 in chips)
Seat 7: sapinho1001 (3514 in chips)
Seat 9: held (17652 in chips)
Fischersito: posts the ante 25
Thore H: posts the ante 25
Irisha2: posts the ante 25
DmelloH: posts the ante 25
Zanussof: posts the ante 25
morena211: posts the ante 25
sapinho1001: posts the ante 25
held: posts the ante 25
morena211: posts small blind 200
sapinho1001: posts big blind 400
*** HOLE CARDS ***
Dealt to held [Qs 6d]
held: folds
Fischersito: folds
Thore H: folds
Irisha2: folds
DmelloH: folds
Zanussof: folds
morena211: calls 200
sapinho1001: raises 1000 to 1400
morena211: folds
Uncalled bet (1000) returned to sapinho1001
sapinho1001 collected 1000 from pot
sapinho1001: doesn't show hand
*** SUMMARY ***
Total pot 1000 | Rake 0
Seat 1: Fischersito folded before Flop (didn't bet)
Seat 2: Thore H folded before Flop (didn't bet)
Seat 3: Irisha2 folded before Flop (didn't bet)
Seat 4: DmelloH folded before Flop (didn't bet)
Seat 5: Zanussof (button) folded before Flop (didn't bet)
Seat 6: morena211 (small blind) folded before Flop
Seat 7: sapinho1001 (big blind) collected (1000)
Seat 9: held folded before Flop (didn't bet)


*********** # 47 **************
PokerStars Hand #149651683447: Tournament #1495192630, $0.91+$0.09 USD Hold'em No Limit - Level IX (200/400) - 2016/03/01 1:10:05 ET
Table '1495192630 3' 9-max Seat #4 is the button
Seat 1: Fischersito (6770 in chips)
Seat 2: Thore H (19160 in chips)
Seat 3: Irisha2 (10299 in chips)
Seat 4: DmelloH (5268 in chips)
Seat 5: Zanussof (4005 in chips)
Seat 6: morena211 (1582 in chips)
Seat 7: sapinho1001 (3539 in chips)
Seat 9: held (16877 in chips)
Fischersito: posts the ante 25
Thore H: posts the ante 25
Irisha2: posts the ante 25
DmelloH: posts the ante 25
Zanussof: posts the ante 25
morena211: posts the ante 25
sapinho1001: posts the ante 25
held: posts the ante 25
Zanussof: posts small blind 200
morena211: posts big blind 400
*** HOLE CARDS ***
Dealt to held [As 8s]
sapinho1001: folds
held: raises 757 to 1157
Fischersito: folds
Thore H: folds
Irisha2: folds
DmelloH: folds
Zanussof: folds
morena211: folds
Uncalled bet (757) returned to held
held collected 1200 from pot
held: doesn't show hand
*** SUMMARY ***
Total pot 1200 | Rake 0
Seat 1: Fischersito folded before Flop (didn't bet)
Seat 2: Thore H folded before Flop (didn't bet)
Seat 3: Irisha2 folded before Flop (didn't bet)
Seat 4: DmelloH (button) folded before Flop (didn't bet)
Seat 5: Zanussof (small blind) folded before Flop
Seat 6: morena211 (big blind) folded before Flop
Seat 7: sapinho1001 folded before Flop (didn't bet)
Seat 9: held collected (1200)


*********** # 48 **************
PokerStars Hand #149651676973: Tournament #1495192630, $0.91+$0.09 USD Hold'em No Limit - Level IX (200/400) - 2016/03/01 1:09:41 ET
Table '1495192630 3' 9-max Seat #3 is the button
Seat 1: Fischersito (6795 in chips)
Seat 2: Thore H (19185 in chips)
Seat 3: Irisha2 (9524 in chips)
Seat 4: DmelloH (5493 in chips)
Seat 5: Zanussof (4430 in chips)
Seat 6: morena211 (1607 in chips)
Seat 7: sapinho1001 (3564 in chips)
Seat 9: held (16902 in chips)
Fischersito: posts the ante 25
Thore H: posts the ante 25
Irisha2: posts the ante 25
DmelloH: posts the ante 25
Zanussof: posts the ante 25
morena211: posts the ante 25
sapinho1001: posts the ante 25
held: posts the ante 25
DmelloH: posts small blind 200
Zanussof: posts big blind 400
*** HOLE CARDS ***
Dealt to held [Jc 9s]
morena211: folds
sapinho1001: folds
held: folds
Fischersito: folds
Thore H: folds
Irisha2: calls 400
DmelloH: folds
Zanussof: checks
*** FLOP *** [Jh 5c Ac]
Zanussof: checks
Irisha2: bets 400
Zanussof: folds
Uncalled bet (400) returned to Irisha2
Irisha2 collected 1200 from pot
Irisha2: doesn't show hand
*** SUMMARY ***
Total pot 1200 | Rake 0
Board [Jh 5c Ac]
Seat 1: Fischersito folded before Flop (didn't bet)
Seat 2: Thore H folded before Flop (didn't bet)
Seat 3: Irisha2 (button) collected (1200)
Seat 4: DmelloH (small blind) folded before Flop
Seat 5: Zanussof (big blind) folded on the Flop
Seat 6: morena211 folded before Flop (didn't bet)
Seat 7: sapinho1001 folded before Flop (didn't bet)
Seat 9: held folded before Flop (didn't bet)


*********** # 49 **************
PokerStars Hand #149651661616: Tournament #1495192630, $0.91+$0.09 USD Hold'em No Limit - Level IX (200/400) - 2016/03/01 1:08:43 ET
Table '1495192630 3' 9-max Seat #2 is the button
Seat 1: Fischersito (6820 in chips)
Seat 2: Thore H (19210 in chips)
Seat 3: Irisha2 (9749 in chips)
Seat 4: DmelloH (6517 in chips)
Seat 5: Zanussof (4455 in chips)
Seat 6: morena211 (1632 in chips)
Seat 7: sapinho1001 (3589 in chips)
Seat 9: held (15528 in chips)
Fischersito: posts the ante 25
Thore H: posts the ante 25
Irisha2: posts the ante 25
DmelloH: posts the ante 25
Zanussof: posts the ante 25
morena211: posts the ante 25
sapinho1001: posts the ante 25
held: posts the ante 25
Irisha2: posts small blind 200
DmelloH: posts big blind 400
*** HOLE CARDS ***
Dealt to held [Ts Ac]
Zanussof: folds
morena211: folds
sapinho1001: folds
held: raises 599 to 999
Fischersito: folds
Thore H: folds
Irisha2: folds
DmelloH: calls 599
*** FLOP *** [4c Jd Jc]
DmelloH: checks
held: bets 1111
DmelloH: folds
Uncalled bet (1111) returned to held
held collected 2398 from pot
held: doesn't show hand
*** SUMMARY ***
Total pot 2398 | Rake 0
Board [4c Jd Jc]
Seat 1: Fischersito folded before Flop (didn't bet)
Seat 2: Thore H (button) folded before Flop (didn't bet)
Seat 3: Irisha2 (small blind) folded before Flop
Seat 4: DmelloH (big blind) folded on the Flop
Seat 5: Zanussof folded before Flop (didn't bet)
Seat 6: morena211 folded before Flop (didn't bet)
Seat 7: sapinho1001 folded before Flop (didn't bet)
Seat 9: held collected (2398)


*********** # 50 **************
PokerStars Hand #149651655180: Tournament #1495192630, $0.91+$0.09 USD Hold'em No Limit - Level IX (200/400) - 2016/03/01 1:08:18 ET
Table '1495192630 3' 9-max Seat #1 is the button
Seat 1: Fischersito (6845 in chips)
Seat 2: Thore H (19435 in chips)
Seat 3: Irisha2 (10174 in chips)
Seat 4: DmelloH (6542 in chips)
Seat 5: Zanussof (4480 in chips)
Seat 6: morena211 (1657 in chips)
Seat 7: sapinho1001 (3614 in chips)
Seat 9: held (14753 in chips)
Fischersito: posts the ante 25
Thore H: posts the ante 25
Irisha2: posts the ante 25
DmelloH: posts the ante 25
Zanussof: posts the ante 25
morena211: posts the ante 25
sapinho1001: posts the ante 25
held: posts the ante 25
Thore H: posts small blind 200
Irisha2: posts big blind 400
*** HOLE CARDS ***
Dealt to held [Kd Qd]
DmelloH: folds
Zanussof: folds
morena211: folds
sapinho1001: folds
held: raises 599 to 999
Fischersito: folds
Thore H: folds
Irisha2: folds
Uncalled bet (599) returned to held
held collected 1200 from pot
held: doesn't show hand
*** SUMMARY ***
Total pot 1200 | Rake 0
Seat 1: Fischersito (button) folded before Flop (didn't bet)
Seat 2: Thore H (small blind) folded before Flop
Seat 3: Irisha2 (big blind) folded before Flop
Seat 4: DmelloH folded before Flop (didn't bet)
Seat 5: Zanussof folded before Flop (didn't bet)
Seat 6: morena211 folded before Flop (didn't bet)
Seat 7: sapinho1001 folded before Flop (didn't bet)
Seat 9: held collected (1200)


*********** # 51 **************
PokerStars Hand #149651638393: Tournament #1495192630, $0.91+$0.09 USD Hold'em No Limit - Level IX (200/400) - 2016/03/01 1:07:15 ET
Table '1495192630 3' 9-max Seat #9 is the button
Seat 1: Fischersito (7070 in chips)
Seat 2: Thore H (19860 in chips)
Seat 3: Irisha2 (10199 in chips)
Seat 4: DmelloH (6567 in chips)
Seat 5: Zanussof (4505 in chips)
Seat 6: morena211 (1682 in chips)
Seat 7: sapinho1001 (3639 in chips)
Seat 8: celiaobutlee (2893 in chips)
Seat 9: held (11085 in chips)
Fischersito: posts the ante 25
Thore H: posts the ante 25
Irisha2: posts the ante 25
DmelloH: posts the ante 25
Zanussof: posts the ante 25
morena211: posts the ante 25
sapinho1001: posts the ante 25
celiaobutlee: posts the ante 25
held: posts the ante 25
Fischersito: posts small blind 200
Thore H: posts big blind 400
*** HOLE CARDS ***
Dealt to held [Td Tc]
Irisha2: folds
DmelloH: folds
Zanussof: folds
morena211: folds
sapinho1001: folds
celiaobutlee: raises 400 to 800
held: raises 1199 to 1999
Fischersito: folds
Thore H: folds
celiaobutlee: calls 1199
*** FLOP *** [4h Kc Ah]
celiaobutlee: checks
held: bets 869
celiaobutlee: calls 869 and is all-in
*** TURN *** [4h Kc Ah] [Ad]
*** RIVER *** [4h Kc Ah Ad] [6s]
*** SHOW DOWN ***
celiaobutlee: shows [Jc Qs] (a pair of Aces)
held: shows [Td Tc] (two pair, Aces and Tens)
held collected 6561 from pot
celiaobutlee finished the tournament in 9th place
*** SUMMARY ***
Total pot 6561 | Rake 0
Board [4h Kc Ah Ad 6s]
Seat 1: Fischersito (small blind) folded before Flop
Seat 2: Thore H (big blind) folded before Flop
Seat 3: Irisha2 folded before Flop (didn't bet)
Seat 4: DmelloH folded before Flop (didn't bet)
Seat 5: Zanussof folded before Flop (didn't bet)
Seat 6: morena211 folded before Flop (didn't bet)
Seat 7: sapinho1001 folded before Flop (didn't bet)
Seat 8: celiaobutlee showed [Jc Qs] and lost with a pair of Aces
Seat 9: held (button) showed [Td Tc] and won (6561) with two pair, Aces and Tens


*********** # 52 **************
PokerStars Hand #149651631064: Tournament #1495192630, $0.91+$0.09 USD Hold'em No Limit - Level IX (200/400) - 2016/03/01 1:06:47 ET
Table '1495192630 3' 9-max Seat #8 is the button
Seat 1: Fischersito (7495 in chips)
Seat 2: Thore H (19885 in chips)
Seat 3: Irisha2 (10224 in chips)
Seat 4: DmelloH (6592 in chips)
Seat 5: Zanussof (4530 in chips)
Seat 6: morena211 (1707 in chips)
Seat 7: sapinho1001 (3664 in chips)
Seat 8: celiaobutlee (3718 in chips)
Seat 9: held (9685 in chips)
Fischersito: posts the ante 25
Thore H: posts the ante 25
Irisha2: posts the ante 25
DmelloH: posts the ante 25
Zanussof: posts the ante 25
morena211: posts the ante 25
sapinho1001: posts the ante 25
celiaobutlee: posts the ante 25
held: posts the ante 25
held: posts small blind 200
Fischersito: posts big blind 400
*** HOLE CARDS ***
Dealt to held [Jh As]
Thore H: folds
Irisha2: folds
DmelloH: folds
Zanussof: folds
morena211: folds
sapinho1001: folds
celiaobutlee: raises 400 to 800
held: raises 1199 to 1999
Fischersito: folds
celiaobutlee: folds
Uncalled bet (1199) returned to held
held collected 2225 from pot
held: doesn't show hand
*** SUMMARY ***
Total pot 2225 | Rake 0
Seat 1: Fischersito (big blind) folded before Flop
Seat 2: Thore H folded before Flop (didn't bet)
Seat 3: Irisha2 folded before Flop (didn't bet)
Seat 4: DmelloH folded before Flop (didn't bet)
Seat 5: Zanussof folded before Flop (didn't bet)
Seat 6: morena211 folded before Flop (didn't bet)
Seat 7: sapinho1001 folded before Flop (didn't bet)
Seat 8: celiaobutlee (button) folded before Flop
Seat 9: held (small blind) collected (2225)


*********** # 53 **************
PokerStars Hand #149651622445: Tournament #1495192630, $0.91+$0.09 USD Hold'em No Limit - Level IX (200/400) - 2016/03/01 1:06:14 ET
Table '1495192630 3' 9-max Seat #7 is the button
Seat 1: Fischersito (7520 in chips)
Seat 2: Thore H (19910 in chips)
Seat 3: Irisha2 (6624 in chips)
Seat 4: DmelloH (6617 in chips)
Seat 5: Zanussof (4555 in chips)
Seat 6: morena211 (4532 in chips)
Seat 7: sapinho1001 (3689 in chips)
Seat 8: celiaobutlee (3943 in chips)
Seat 9: held (10110 in chips)
Fischersito: posts the ante 25
Thore H: posts the ante 25
Irisha2: posts the ante 25
DmelloH: posts the ante 25
Zanussof: posts the ante 25
morena211: posts the ante 25
sapinho1001: posts the ante 25
celiaobutlee: posts the ante 25
held: posts the ante 25
celiaobutlee: posts small blind 200
held: posts big blind 400
*** HOLE CARDS ***
Dealt to held [7d 5h]
Fischersito: folds
Thore H: folds
Irisha2: raises 800 to 1200
DmelloH: folds
Zanussof: folds
morena211: calls 1200
sapinho1001: folds
celiaobutlee: folds
held: folds
*** FLOP *** [2h 2c 3c]
Irisha2: bets 400
morena211: calls 400
*** TURN *** [2h 2c 3c] [4d]
Irisha2: bets 400
morena211: calls 400
*** RIVER *** [2h 2c 3c 4d] [3s]
Irisha2: bets 800
morena211: calls 800
*** SHOW DOWN ***
Irisha2: shows [Ad Qs] (two pair, Threes and Deuces)
morena211: mucks hand
Irisha2 collected 6425 from pot
*** SUMMARY ***
Total pot 6425 | Rake 0
Board [2h 2c 3c 4d 3s]
Seat 1: Fischersito folded before Flop (didn't bet)
Seat 2: Thore H folded before Flop (didn't bet)
Seat 3: Irisha2 showed [Ad Qs] and won (6425) with two pair, Threes and Deuces
Seat 4: DmelloH folded before Flop (didn't bet)
Seat 5: Zanussof folded before Flop (didn't bet)
Seat 6: morena211 mucked [Th Kd]
Seat 7: sapinho1001 (button) folded before Flop (didn't bet)
Seat 8: celiaobutlee (small blind) folded before Flop
Seat 9: held (big blind) folded before Flop


*********** # 54 **************
PokerStars Hand #149651611173: Tournament #1495192630, $0.91+$0.09 USD Hold'em No Limit - Level IX (200/400) - 2016/03/01 1:05:32 ET
Table '1495192630 3' 9-max Seat #6 is the button
Seat 1: Fischersito (7545 in chips)
Seat 2: Thore H (19935 in chips)
Seat 3: Irisha2 (6649 in chips)
Seat 4: DmelloH (3021 in chips)
Seat 5: Zanussof (4580 in chips)
Seat 6: morena211 (4557 in chips)
Seat 7: sapinho1001 (6710 in chips)
Seat 8: celiaobutlee (4368 in chips)
Seat 9: held (10135 in chips)
Fischersito: posts the ante 25
Thore H: posts the ante 25
Irisha2: posts the ante 25
DmelloH: posts the ante 25
Zanussof: posts the ante 25
morena211: posts the ante 25
sapinho1001: posts the ante 25
celiaobutlee: posts the ante 25
held: posts the ante 25
sapinho1001: posts small blind 200
celiaobutlee: posts big blind 400
*** HOLE CARDS ***
Dealt to held [2c 7c]
held: folds
Fischersito: folds
Thore H: folds
Irisha2: folds
DmelloH: raises 800 to 1200
Zanussof: folds
morena211: folds
sapinho1001: raises 3025 to 4225
celiaobutlee: folds
DmelloH: calls 1796 and is all-in
Uncalled bet (1229) returned to sapinho1001
*** FLOP *** [Qh 6c Jh]
*** TURN *** [Qh 6c Jh] [Th]
*** RIVER *** [Qh 6c Jh Th] [9c]
*** SHOW DOWN ***
sapinho1001: shows [8h 8s] (a straight, Eight to Queen)
DmelloH: shows [Kh Kc] (a straight, Nine to King)
DmelloH collected 6617 from pot
*** SUMMARY ***
Total pot 6617 | Rake 0
Board [Qh 6c Jh Th 9c]
Seat 1: Fischersito folded before Flop (didn't bet)
Seat 2: Thore H folded before Flop (didn't bet)
Seat 3: Irisha2 folded before Flop (didn't bet)
Seat 4: DmelloH showed [Kh Kc] and won (6617) with a straight, Nine to King
Seat 5: Zanussof folded before Flop (didn't bet)
Seat 6: morena211 (button) folded before Flop (didn't bet)
Seat 7: sapinho1001 (small blind) showed [8h 8s] and lost with a straight, Eight to Queen
Seat 8: celiaobutlee (big blind) folded before Flop
Seat 9: held folded before Flop (didn't bet)


*********** # 55 **************
PokerStars Hand #149651593944: Tournament #1495192630, $0.91+$0.09 USD Hold'em No Limit - Level VIII (150/300) - 2016/03/01 1:04:26 ET
Table '1495192630 3' 9-max Seat #5 is the button
Seat 1: Fischersito (5245 in chips)
Seat 2: Thore H (19960 in chips)
Seat 3: Irisha2 (6674 in chips)
Seat 4: DmelloH (3046 in chips)
Seat 5: Zanussof (4605 in chips)
Seat 6: morena211 (6382 in chips)
Seat 7: sapinho1001 (7035 in chips)
Seat 8: celiaobutlee (4393 in chips)
Seat 9: held (10160 in chips)
Fischersito: posts the ante 25
Thore H: posts the ante 25
Irisha2: posts the ante 25
DmelloH: posts the ante 25
Zanussof: posts the ante 25
morena211: posts the ante 25
sapinho1001: posts the ante 25
celiaobutlee: posts the ante 25
held: posts the ante 25
morena211: posts small blind 150
sapinho1001: posts big blind 300
*** HOLE CARDS ***
Dealt to held [Td Qd]
celiaobutlee: folds
held: folds
Fischersito: raises 300 to 600
Thore H: folds
Irisha2: folds
DmelloH: folds
Zanussof: folds
morena211: calls 450
sapinho1001: folds
*** FLOP *** [Kc Ah 6h]
morena211: checks
Fischersito: bets 900
morena211: calls 900
*** TURN *** [Kc Ah 6h] [5d]
morena211: checks
Fischersito: checks
*** RIVER *** [Kc Ah 6h 5d] [8d]
morena211: bets 300
Fischersito: calls 300
*** SHOW DOWN ***
morena211: shows [Th Ks] (a pair of Kings)
Fischersito: shows [As 7s] (a pair of Aces)
Fischersito collected 4125 from pot
*** SUMMARY ***
Total pot 4125 | Rake 0
Board [Kc Ah 6h 5d 8d]
Seat 1: Fischersito showed [As 7s] and won (4125) with a pair of Aces
Seat 2: Thore H folded before Flop (didn't bet)
Seat 3: Irisha2 folded before Flop (didn't bet)
Seat 4: DmelloH folded before Flop (didn't bet)
Seat 5: Zanussof (button) folded before Flop (didn't bet)
Seat 6: morena211 (small blind) showed [Th Ks] and lost with a pair of Kings
Seat 7: sapinho1001 (big blind) folded before Flop
Seat 8: celiaobutlee folded before Flop (didn't bet)
Seat 9: held folded before Flop (didn't bet)


*********** # 56 **************
PokerStars Hand #149651573400: Tournament #1495192630, $0.91+$0.09 USD Hold'em No Limit - Level VIII (150/300) - 2016/03/01 1:03:08 ET
Table '1495192630 2' 9-max Seat #1 is the button
Seat 1: held (10185 in chips)
Seat 2: Thore H (14716 in chips)
Seat 3: Fischersito (5570 in chips)
Seat 6: sapinho1001 (8235 in chips)
Seat 7: shibaba420 (3694 in chips)
held: posts the ante 25
Thore H: posts the ante 25
Fischersito: posts the ante 25
sapinho1001: posts the ante 25
shibaba420: posts the ante 25
Thore H: posts small blind 150
Fischersito: posts big blind 300
*** HOLE CARDS ***
Dealt to held [Qc 2h]
sapinho1001: raises 875 to 1175
shibaba420: raises 2494 to 3669 and is all-in
held: folds
Thore H: raises 11022 to 14691 and is all-in
Fischersito: folds
sapinho1001: folds
Uncalled bet (11022) returned to Thore H
*** FLOP *** [Ad Td 9h]
*** TURN *** [Ad Td 9h] [4d]
*** RIVER *** [Ad Td 9h 4d] [9d]
*** SHOW DOWN ***
Thore H: shows [Kh Kd] (a flush, Ace high)
shibaba420: shows [Qh Ac] (two pair, Aces and Nines)
Thore H collected 8938 from pot
shibaba420 finished the tournament in 10th place
*** SUMMARY ***
Total pot 8938 | Rake 0
Board [Ad Td 9h 4d 9d]
Seat 1: held (button) folded before Flop (didn't bet)
Seat 2: Thore H (small blind) showed [Kh Kd] and won (8938) with a flush, Ace high
Seat 3: Fischersito (big blind) folded before Flop
Seat 6: sapinho1001 folded before Flop
Seat 7: shibaba420 showed [Qh Ac] and lost with two pair, Aces and Nines


*********** # 57 **************
PokerStars Hand #149651558342: Tournament #1495192630, $0.91+$0.09 USD Hold'em No Limit - Level VIII (150/300) - 2016/03/01 1:02:10 ET
Table '1495192630 2' 9-max Seat #7 is the button
Seat 1: held (10360 in chips)
Seat 2: Thore H (13166 in chips)
Seat 6: sapinho1001 (9585 in chips)
Seat 7: shibaba420 (3719 in chips)
held: posts the ante 25
Thore H: posts the ante 25
sapinho1001: posts the ante 25
shibaba420: posts the ante 25
held: posts small blind 150
Thore H: posts big blind 300
*** HOLE CARDS ***
Dealt to held [6d Tc]
sapinho1001: raises 300 to 600
shibaba420: folds
held: folds
Thore H: calls 300
*** FLOP *** [2h 7d 9d]
Thore H: checks
sapinho1001: bets 725
Thore H: calls 725
*** TURN *** [2h 7d 9d] [Kd]
Thore H: checks
sapinho1001: checks
*** RIVER *** [2h 7d 9d Kd] [5h]
Thore H: bets 600
sapinho1001: folds
Uncalled bet (600) returned to Thore H
Thore H collected 2900 from pot
*** SUMMARY ***
Total pot 2900 | Rake 0
Board [2h 7d 9d Kd 5h]
Seat 1: held (small blind) folded before Flop
Seat 2: Thore H (big blind) collected (2900)
Seat 6: sapinho1001 folded on the River
Seat 7: shibaba420 (button) folded before Flop (didn't bet)


*********** # 58 **************
PokerStars Hand #149651550769: Tournament #1495192630, $0.91+$0.09 USD Hold'em No Limit - Level VIII (150/300) - 2016/03/01 1:01:40 ET
Table '1495192630 2' 9-max Seat #6 is the button
Seat 1: held (10685 in chips)
Seat 2: Thore H (13191 in chips)
Seat 5: Lukaz516 (1582 in chips)
Seat 6: sapinho1001 (7478 in chips)
Seat 7: shibaba420 (3894 in chips)
held: posts the ante 25
Thore H: posts the ante 25
Lukaz516: posts the ante 25
sapinho1001: posts the ante 25
shibaba420: posts the ante 25
shibaba420: posts small blind 150
held: posts big blind 300
*** HOLE CARDS ***
Dealt to held [7d Td]
Thore H: folds
Lukaz516: raises 1257 to 1557 and is all-in
sapinho1001: calls 1557
shibaba420: folds
held: folds
*** FLOP *** [4c 7s 3d]
*** TURN *** [4c 7s 3d] [Ad]
*** RIVER *** [4c 7s 3d Ad] [Jd]
*** SHOW DOWN ***
Lukaz516: shows [Jh Qh] (a pair of Jacks)
sapinho1001: shows [7h As] (two pair, Aces and Sevens)
sapinho1001 collected 3689 from pot
Lukaz516 finished the tournament in 11th place
*** SUMMARY ***
Total pot 3689 | Rake 0
Board [4c 7s 3d Ad Jd]
Seat 1: held (big blind) folded before Flop
Seat 2: Thore H folded before Flop (didn't bet)
Seat 5: Lukaz516 showed [Jh Qh] and lost with a pair of Jacks
Seat 6: sapinho1001 (button) showed [7h As] and won (3689) with two pair, Aces and Sevens
Seat 7: shibaba420 (small blind) folded before Flop


*********** # 59 **************
PokerStars Hand #149651545430: Tournament #1495192630, $0.91+$0.09 USD Hold'em No Limit - Level VIII (150/300) - 2016/03/01 1:01:19 ET
Table '1495192630 2' 9-max Seat #5 is the button
Seat 1: held (10710 in chips)
Seat 2: Thore H (12641 in chips)
Seat 5: Lukaz516 (1607 in chips)
Seat 6: sapinho1001 (7653 in chips)
Seat 7: shibaba420 (4219 in chips)
held: posts the ante 25
Thore H: posts the ante 25
Lukaz516: posts the ante 25
sapinho1001: posts the ante 25
shibaba420: posts the ante 25
sapinho1001: posts small blind 150
shibaba420: posts big blind 300
*** HOLE CARDS ***
Dealt to held [2c 4h]
held: folds
Thore H: raises 300 to 600
Lukaz516: folds
sapinho1001: folds
shibaba420: folds
Uncalled bet (300) returned to Thore H
Thore H collected 875 from pot
*** SUMMARY ***
Total pot 875 | Rake 0
Seat 1: held folded before Flop (didn't bet)
Seat 2: Thore H collected (875)
Seat 5: Lukaz516 (button) folded before Flop (didn't bet)
Seat 6: sapinho1001 (small blind) folded before Flop
Seat 7: shibaba420 (big blind) folded before Flop


*********** # 60 **************
PokerStars Hand #149651529496: Tournament #1495192630, $0.91+$0.09 USD Hold'em No Limit - Level VIII (150/300) - 2016/03/01 1:00:17 ET
Table '1495192630 2' 9-max Seat #2 is the button
Seat 1: held (10160 in chips)
Seat 2: Thore H (12666 in chips)
Seat 5: Lukaz516 (1782 in chips)
Seat 6: sapinho1001 (7978 in chips)
Seat 7: shibaba420 (4244 in chips)
held: posts the ante 25
Thore H: posts the ante 25
Lukaz516: posts the ante 25
sapinho1001: posts the ante 25
shibaba420: posts the ante 25
Lukaz516: posts small blind 150
sapinho1001: posts big blind 300
*** HOLE CARDS ***
Dealt to held [Ah 8d]
shibaba420: folds
held: raises 477 to 777
Thore H: folds
Lukaz516: folds
sapinho1001: folds
Uncalled bet (477) returned to held
held collected 875 from pot
held: doesn't show hand
*** SUMMARY ***
Total pot 875 | Rake 0
Seat 1: held collected (875)
Seat 2: Thore H (button) folded before Flop (didn't bet)
Seat 5: Lukaz516 (small blind) folded before Flop
Seat 6: sapinho1001 (big blind) folded before Flop
Seat 7: shibaba420 folded before Flop (didn't bet)


*********** # 61 **************
PokerStars Hand #149651451985: Tournament #1495192630, $0.91+$0.09 USD Hold'em No Limit - Level VIII (150/300) - 2016/03/01 0:54:57 ET
Table '1495192630 2' 9-max Seat #1 is the button
Seat 1: held (9610 in chips)
Seat 2: Thore H (12841 in chips)
Seat 5: Lukaz516 (2107 in chips)
Seat 6: sapinho1001 (8003 in chips)
Seat 7: shibaba420 (4269 in chips)
held: posts the ante 25
Thore H: posts the ante 25
Lukaz516: posts the ante 25
sapinho1001: posts the ante 25
shibaba420: posts the ante 25
Thore H: posts small blind 150
Lukaz516: posts big blind 300
*** HOLE CARDS ***
Dealt to held [8s Jd]
sapinho1001: folds
shibaba420: folds
held: raises 477 to 777
Thore H: folds
Lukaz516: folds
Uncalled bet (477) returned to held
held collected 875 from pot
held: doesn't show hand
*** SUMMARY ***
Total pot 875 | Rake 0
Seat 1: held (button) collected (875)
Seat 2: Thore H (small blind) folded before Flop
Seat 5: Lukaz516 (big blind) folded before Flop
Seat 6: sapinho1001 folded before Flop (didn't bet)
Seat 7: shibaba420 folded before Flop (didn't bet)


*********** # 62 **************
PokerStars Hand #149651439997: Tournament #1495192630, $0.91+$0.09 USD Hold'em No Limit - Level VIII (150/300) - 2016/03/01 0:54:13 ET
Table '1495192630 2' 9-max Seat #7 is the button
Seat 1: held (10301 in chips)
Seat 2: Thore H (12075 in chips)
Seat 5: Lukaz516 (2132 in chips)
Seat 6: sapinho1001 (8028 in chips)
Seat 7: shibaba420 (4294 in chips)
held: posts the ante 25
Thore H: posts the ante 25
Lukaz516: posts the ante 25
sapinho1001: posts the ante 25
shibaba420: posts the ante 25
held: posts small blind 150
Thore H: posts big blind 300
*** HOLE CARDS ***
Dealt to held [Qd Ts]
Lukaz516: folds
sapinho1001: folds
shibaba420: folds
held: raises 366 to 666
Thore H: raises 11384 to 12050 and is all-in
held: folds
Uncalled bet (11384) returned to Thore H
Thore H collected 1457 from pot
Thore H: doesn't show hand
*** SUMMARY ***
Total pot 1457 | Rake 0
Seat 1: held (small blind) folded before Flop
Seat 2: Thore H (big blind) collected (1457)
Seat 5: Lukaz516 folded before Flop (didn't bet)
Seat 6: sapinho1001 folded before Flop (didn't bet)
Seat 7: shibaba420 (button) folded before Flop (didn't bet)


*********** # 63 **************
PokerStars Hand #149651430063: Tournament #1495192630, $0.91+$0.09 USD Hold'em No Limit - Level VIII (150/300) - 2016/03/01 0:53:36 ET
Table '1495192630 2' 9-max Seat #6 is the button
Seat 1: held (9901 in chips)
Seat 2: Thore H (12100 in chips)
Seat 5: Lukaz516 (2157 in chips)
Seat 6: sapinho1001 (8053 in chips)
Seat 7: shibaba420 (4619 in chips)
held: posts the ante 25
Thore H: posts the ante 25
Lukaz516: posts the ante 25
sapinho1001: posts the ante 25
shibaba420: posts the ante 25
shibaba420: posts small blind 150
held: posts big blind 300
*** HOLE CARDS ***
Dealt to held [Ad 9h]
Thore H: folds
Lukaz516: folds
sapinho1001: folds
shibaba420: calls 150
held: raises 1033 to 1333
shibaba420: folds
Uncalled bet (1033) returned to held
held collected 725 from pot
held: doesn't show hand
*** SUMMARY ***
Total pot 725 | Rake 0
Seat 1: held (big blind) collected (725)
Seat 2: Thore H folded before Flop (didn't bet)
Seat 5: Lukaz516 folded before Flop (didn't bet)
Seat 6: sapinho1001 (button) folded before Flop (didn't bet)
Seat 7: shibaba420 (small blind) folded before Flop


*********** # 64 **************
PokerStars Hand #149651412132: Tournament #1495192630, $0.91+$0.09 USD Hold'em No Limit - Level VIII (150/300) - 2016/03/01 0:52:29 ET
Table '1495192630 2' 9-max Seat #5 is the button
Seat 1: held (8085 in chips)
Seat 2: Thore H (13391 in chips)
Seat 5: Lukaz516 (2182 in chips)
Seat 6: sapinho1001 (8228 in chips)
Seat 7: shibaba420 (4944 in chips)
held: posts the ante 25